"aa" = (/turf/simulated/wall,/area/space)
"ab" = (/obj/effect/floor_decal/corner/green,/turf/simulated/floor/tiled{color = "#46725c"},/area/space)
"ac" = (/obj/effect/floor_decal/corner/green{dir = 10},/obj/machinery/light/colored/green{tag = "icon-green1 (NORTH)"; icon_state = "green1"; dir = 1},/turf/simulated/floor/tiled{color = "#46725c"},/area/space)
"ad" = (/obj/effect/floor_decal/corner/green{dir = 8},/turf/simulated/floor/tiled{color = "#46725c"},/area/space)
"ae" = (/obj/structure/table/glass,/obj/machinery/recharger,/turf/simulated/floor/holofloor/tiled,/area/space)
"af" = (/obj/structure/table/glass,/obj/machinery/computer/security/telescreen/entertainment{icon_state = "frame"; pixel_x = 0; pixel_y = 32},/turf/simulated/floor/holofloor/tiled,/area/space)
"ag" = (/obj/structure/table/glass,/obj/machinery/recharger/wallcharger{pixel_y = 21},/turf/simulated/floor/holofloor/tiled,/area/space)
"ah" = (/obj/structure/table/glass,/obj/machinery/light/colored/green{tag = "icon-green1 (NORTH)"; icon_state = "green1"; dir = 1},/turf/simulated/floor/holofloor/tiled,/area/space)
"ai" = (/obj/machinery/vending/tool,/turf/simulated/floor/holofloor/tiled,/area/space)
"aj" = (/obj/machinery/vending/assist,/turf/simulated/floor/holofloor/tiled,/area/space)
"ak" = (/obj/effect/floor_decal/corner/green/full{dir = 4},/turf/simulated/floor/tiled{color = "#46725c"},/area/space)
"al" = (/obj/machinery/light/floor,/turf/simulated/floor/tiled{color = "green"},/area/space)
"am" = (/obj/effect/floor_decal/corner/green/full,/turf/simulated/floor/tiled{color = "#46725c"},/area/space)
"an" = (/obj/effect/floor_decal/corner/green{dir = 10},/turf/simulated/floor/holofloor/tiled,/area/space)
"ao" = (/obj/effect/floor_decal/corner/green{dir = 9},/turf/simulated/floor/tiled{color = "#46725c"},/area/space)
"ap" = (/turf/simulated/floor/tiled{color = "green"},/area/space)
"aq" = (/obj/effect/floor_decal/corner/green,/turf/simulated/floor/tiled{color = "green"},/area/space)
"ar" = (/obj/effect/floor_decal/corner/green{dir = 10},/turf/simulated/floor/tiled{color = "green"},/area/space)
"as" = (/obj/effect/floor_decal/corner/green{dir = 8},/turf/simulated/floor/tiled{color = "green"},/area/space)
"at" = (/obj/machinery/light/colored/green{tag = "icon-green1 (WEST)"; icon_state = "green1"; dir = 8},/obj/effect/floor_decal/corner/green{dir = 9},/turf/simulated/floor/tiled{color = "#46725c"},/area/space)
"au" = (/obj/machinery/door/airlock/multi_tile{icon_state = "closed"; dir = 8},/turf/simulated/floor/tiled{color = "green"},/area/space)
"av" = (/obj/machinery/light/colored/green,/obj/effect/floor_decal/corner/green/full{dir = 4},/turf/simulated/floor/tiled{color = "green"},/area/space)
"aw" = (/obj/machinery/recharge_station,/turf/simulated/floor/tiled{color = "#46725c"},/area/space)
"ax" = (/obj/machinery/light/colored/green,/obj/effect/floor_decal/corner/green/full,/turf/simulated/floor/tiled{color = "green"},/area/space)
"ay" = (/obj/machinery/smartfridge/drinks,/turf/simulated/floor/tiled{color = "#46725c"},/area/space)
"az" = (/obj/machinery/door/window/westleft{dir = 1; icon_state = "right"; req_access = list(30); tag = "icon-right"},/turf/simulated/floor/tiled{color = "#46725c"},/area/space)
"aA" = (/obj/effect/floor_decal/corner/green/full{dir = 1},/turf/simulated/floor/tiled{color = "#46725c"},/area/space)
"aB" = (/obj/effect/floor_decal/corner/green{dir = 6},/turf/simulated/floor/tiled{color = "green"},/area/space)
"aC" = (/obj/structure/window/basic{icon_state = "window"; dir = 1},/obj/structure/window/basic{dir = 8},/obj/machinery/holoplant,/turf/simulated/floor/tiled{color = "#46725c"},/area/space)
"aD" = (/turf/simulated/wall/plastic/green,/area/space)
"aE" = (/obj/structure/window/basic{dir = 4},/obj/structure/window/basic{icon_state = "window"; dir = 1},/obj/machinery/holoplant,/turf/simulated/floor/tiled{color = "#46725c"},/area/space)
"aF" = (/obj/effect/floor_decal/corner/green{dir = 9},/turf/simulated/floor/tiled{color = "green"},/area/space)
"aG" = (/obj/structure/table/glass,/obj/machinery/holoplant,/obj/effect/floor_decal/corner/lime/diagonal,/turf/simulated/floor/tiled{color = "#46725c"},/area/space)
"aH" = (/obj/effect/floor_decal/corner/green{dir = 6},/turf/simulated/floor/tiled{color = "#46725c"},/area/space)
"aI" = (/obj/machinery/modular_computer/console/preset/civilian,/turf/simulated/floor/tiled/old_tile/green,/area/space)
"aJ" = (/obj/machinery/modular_computer/console/preset/civilian,/obj/machinery/light/colored/green{tag = "icon-green1 (NORTH)"; icon_state = "green1"; dir = 1},/turf/simulated/floor/tiled/old_tile/green,/area/space)
"aK" = (/obj/structure/table/glass,/obj/item/weapon/storage/box/glasses/meta,/obj/effect/floor_decal/corner/lime/diagonal,/turf/simulated/floor/tiled{color = "#46725c"},/area/space)
"aL" = (/turf/simulated/floor/carpet/turcarpet,/area/space)
"aM" = (/obj/structure/table/woodentable,/obj/machinery/chemical_dispenser/bar_coffee/full,/turf/simulated/floor/carpet/turcarpet,/area/space)
"aN" = (/obj/machinery/light/colored/green{tag = "icon-green1 (EAST)"; icon_state = "green1"; dir = 4},/obj/effect/floor_decal/corner/green{dir = 6},/turf/simulated/floor/tiled{color = "#46725c"},/area/space)
"aO" = (/obj/machinery/recharger/wallcharger{pixel_y = 21},/obj/machinery/light/floor,/turf/simulated/floor/tiled/techmaint/outdoors,/area/space)
"aP" = (/obj/structure/bed/chair/general{icon_state = "chair_preview"; dir = 1},/turf/simulated/floor/holofloor/tiled/dark,/area/space)
"aQ" = (/obj/structure/table/glass,/obj/effect/floor_decal/corner/lime/diagonal,/turf/simulated/floor/tiled{color = "#46725c"},/area/space)
"aR" = (/obj/structure/table/woodentable,/obj/machinery/chemical_dispenser/bar_alc/full,/turf/simulated/floor/carpet/turcarpet,/area/space)
"aS" = (/turf/simulated/floor/holofloor/tiled/dark,/area/space)
"aT" = (/turf/simulated/floor/tiled/techmaint/outdoors,/area/space)
"aU" = (/obj/structure/table/woodentable,/obj/machinery/chemical_dispenser/bar_soft/full,/turf/simulated/floor/carpet/turcarpet,/area/space)
"aV" = (/obj/structure/filingcabinet/chestdrawer,/turf/simulated/floor/tiled/techmaint/outdoors,/area/space)
"aW" = (/obj/structure/bed/chair/general,/turf/simulated/floor/holofloor/tiled/dark,/area/space)
"aX" = (/obj/structure/curtain/open/color/lime,/turf/simulated/floor/tiled{color = "#46725c"},/area/space)
"aY" = (/obj/machinery/modular_computer/console/preset/civilian{icon_state = "console"; dir = 1},/turf/simulated/floor/tiled/old_tile/green,/area/space)
"aZ" = (/obj/machinery/modular_computer/console/preset/civilian{icon_state = "console"; dir = 1},/obj/machinery/light/colored/green,/turf/simulated/floor/tiled/old_tile/green,/area/space)
"ba" = (/obj/machinery/door/window/westleft{dir = 2; icon_state = "right"; req_access = list(30); tag = "icon-right"},/turf/simulated/floor/tiled{color = "#46725c"},/area/space)
"bb" = (/turf/simulated/floor/tiled{color = "#46725c"},/area/space)
"bc" = (/obj/machinery/light/colored/green{tag = "icon-green1 (NORTH)"; icon_state = "green1"; dir = 1},/turf/simulated/floor/tiled{color = "#46725c"},/area/space)
"bd" = (/obj/structure/bed/chair/general{icon_state = "chair_preview"; dir = 4},/turf/simulated/floor/tiled{color = "green"},/area/space)
"be" = (/obj/structure/table/glass,/turf/simulated/floor/tiled{color = "green"},/area/space)
"bf" = (/obj/structure/bed/chair/general{icon_state = "chair_preview"; dir = 8},/turf/simulated/floor/tiled{color = "green"},/area/space)
"bg" = (/obj/machinery/light/colored/green{dir = 8},/turf/simulated/floor/tiled{color = "#46725c"},/area/space)
"bh" = (/obj/structure/bed/chair/general,/turf/simulated/floor/tiled/techmaint/outdoors,/area/space)
"bi" = (/obj/item/device/mic_stand{icon_state = "micstand"; dir = 8},/turf/simulated/floor/tiled/techmaint/outdoors,/area/space)
"bj" = (/obj/machinery/light/colored/green{tag = "icon-green1 (NORTH)"; icon_state = "green1"; dir = 1},/turf/simulated/floor/tiled/techmaint/outdoors,/area/space)
"bk" = (/obj/structure/bed/chair/sofa/green/right{icon_state = "sofaend_right"; dir = 8},/turf/simulated/floor/tiled{color = "#46725c"},/area/space)
"bl" = (/obj/structure/table/glass,/turf/simulated/floor/carpet/turcarpet,/area/space)
"bm" = (/obj/machinery/light/small{dir = 4; pixel_y = 0},/obj/structure/bed/chair/sofa/green{icon_state = "sofamiddle"; dir = 8},/turf/simulated/floor/tiled{color = "#46725c"},/area/space)
"bn" = (/obj/structure/bed/chair/general{icon_state = "chair_preview"; dir = 1},/turf/simulated/floor/holofloor/tiled,/area/space)
"bo" = (/obj/structure/bed/chair/sofa/green{icon_state = "sofamiddle"; dir = 8},/turf/simulated/floor/tiled{color = "#46725c"},/area/space)
"bp" = (/obj/machinery/light/small{brightness_color = "#DA0205"; brightness_power = 1; brightness_range = 5; dir = 8},/turf/simulated/floor/tiled{color = "#46725c"},/area/space)
"bq" = (/turf/simulated/floor/holofloor/tiled,/area/space)
"br" = (/obj/machinery/light/small,/turf/simulated/floor/tiled{color = "#46725c"},/area/space)
"bs" = (/obj/structure/bed/chair/sofa/green/right{icon_state = "sofaend_right"; dir = 1},/turf/simulated/floor/tiled{color = "#46725c"},/area/space)
"bt" = (/obj/structure/bed/chair/sofa/green{icon_state = "sofamiddle"; dir = 1},/turf/simulated/floor/tiled{color = "#46725c"},/area/space)
"bu" = (/obj/structure/bed/chair/sofa/green/corner{icon_state = "sofacorner"; dir = 8},/turf/simulated/floor/tiled{color = "#46725c"},/area/space)

(1,1,1) = {"
aaaaaaaaaaaaaaaaaaaaaaaaaaaaaaaaaaaa
aaabacadaeafagahaiajahagafaeabacadaa
aaakalamananananananananananakalaoaa
apapapapapapaqarararasapapapapapataa
auapapapaqaravawawawaxarasapaaayazaa
aaaAapapaBaCaDaDaDaDaDaEaFapaGapalaa
aaaHapapaBaDaDaIaJaIaDaDaFapaKaLaMaa
aaaNapapaBaDaOaPaPaPaOaDaFapaQaLaRaa
aaaHapapapaSaSaSaTaSaSaSapapaQaLaUaa
aaaHapapaBaDaVaWaWaWaVaDaFapaGapalaa
aaaDaDaXaDaDaDaYaZaYaDaDaXaaaaaybaaa
aabbbbbbbbbbaDaDaDaDaDbbbbbbbcbbbbaa
aabbbdbebfbgaDaTbhbibjbbbbbbbbbbbkaa
aabbbdbebfbbaDaTaTaTaTbbaLaLaLblbmaa
aabbbdbebfbbaDbnbnbnbnbbaLaLaLblboaa
aabpbdbebfbbaDbqbqbqbqbbblblaLaLboaa
aabbbbbbbbbbaDbnbnbnbnbrbsbtbtbtbuaa
aaaaaaaaaaaaaaaaaaaaaaaaaaaaaaaaaaaa
"}
