"a" = (/turf/template_noop,/area/template_noop)
"b" = (/turf/simulated/floor/outdoors/grass/sif/forest,/area/submap/MilitaryCamp1)
"c" = (/turf/simulated/floor/outdoors/dirt/sif/planetuse,/area/submap/MilitaryCamp1)
"d" = (/obj/effect/mine,/turf/simulated/floor/outdoors/grass/sif/forest,/area/submap/MilitaryCamp1)
"e" = (/obj/structure/flora/bush,/turf/simulated/floor/outdoors/grass/sif/forest,/area/submap/MilitaryCamp1)
"f" = (/obj/effect/decal/cleanable/blood,/turf/simulated/floor/outdoors/grass/sif/forest,/area/submap/MilitaryCamp1)
"g" = (/obj/effect/decal/remains,/turf/simulated/floor/outdoors/dirt/sif/planetuse,/area/submap/MilitaryCamp1)
"h" = (/obj/structure/flora/tree/sif,/turf/simulated/floor/outdoors/grass/sif/forest,/area/submap/MilitaryCamp1)
"i" = (/obj/item/stack/rods,/turf/simulated/floor/outdoors/grass/sif/forest,/area/submap/MilitaryCamp1)
"j" = (/obj/effect/mine,/turf/simulated/floor/outdoors/dirt/sif/planetuse,/area/submap/MilitaryCamp1)
"k" = (/turf/simulated/wall,/area/submap/MilitaryCamp1)
"l" = (/turf/simulated/floor,/area/submap/MilitaryCamp1)
"m" = (/obj/item/weapon/material/shard,/turf/simulated/floor/outdoors/grass/sif/forest,/area/submap/MilitaryCamp1)
"n" = (/obj/structure/table/standard,/turf/simulated/floor/holofloor/tiled{tag = "icon-steel_broken3"; icon_state = "steel_broken3"},/area/submap/MilitaryCamp1)
"o" = (/turf/simulated/floor/holofloor/tiled,/area/submap/MilitaryCamp1)
"p" = (/obj/effect/mine,/turf/simulated/floor,/area/submap/MilitaryCamp1)
"q" = (/obj/structure/table/standard,/obj/item/weapon/gun/energy/gun,/turf/simulated/floor/holofloor/tiled,/area/submap/MilitaryCamp1)
"r" = (/obj/structure/table/standard,/obj/item/weapon/gun/projectile/automatic/c20r,/turf/simulated/floor/holofloor/tiled,/area/submap/MilitaryCamp1)
"s" = (/obj/structure/table/standard,/obj/item/weapon/storage/box/syndie_kit/space,/turf/simulated/floor/holofloor/tiled,/area/submap/MilitaryCamp1)
"t" = (/obj/machinery/door/airlock,/turf/simulated/floor/holofloor/tiled{tag = "icon-steel_broken1"; icon_state = "steel_broken1"},/area/submap/MilitaryCamp1)
"u" = (/mob/living/simple_animal/hostile/viscerator,/turf/simulated/floor/holofloor/tiled,/area/submap/MilitaryCamp1)
"v" = (/turf/simulated/floor/holofloor/tiled{tag = "icon-steel_broken0"; icon_state = "steel_broken0"},/area/submap/MilitaryCamp1)
"w" = (/obj/effect/decal/cleanable/blood,/turf/simulated/floor/holofloor/tiled,/area/submap/MilitaryCamp1)
"x" = (/obj/structure/girder,/turf/simulated/floor,/area/submap/MilitaryCamp1)
"y" = (/obj/machinery/computer/security,/turf/simulated/floor/holofloor/tiled,/area/submap/MilitaryCamp1)
"z" = (/turf/simulated/floor/holofloor/tiled{tag = "icon-steel_burned0"; icon_state = "steel_burned0"},/area/submap/MilitaryCamp1)
"A" = (/obj/machinery/computer/message_monitor,/turf/simulated/floor/holofloor/tiled,/area/submap/MilitaryCamp1)
"B" = (/obj/machinery/door/airlock,/turf/simulated/floor/holofloor/tiled,/area/submap/MilitaryCamp1)
"C" = (/obj/machinery/light,/turf/simulated/floor/holofloor/tiled,/area/submap/MilitaryCamp1)
"D" = (/mob/living/simple_animal/hostile/viscerator,/turf/simulated/floor/holofloor/tiled{tag = "icon-steel_burned0"; icon_state = "steel_burned0"},/area/submap/MilitaryCamp1)
"E" = (/mob/living/simple_animal/hostile/viscerator,/turf/simulated/floor/holofloor/tiled{tag = "icon-steel_broken0"; icon_state = "steel_broken0"},/area/submap/MilitaryCamp1)
"F" = (/obj/structure/flora/tree/dead,/turf/simulated/floor/outdoors/grass/sif/forest,/area/submap/MilitaryCamp1)
"G" = (/obj/structure/door_assembly,/turf/simulated/floor/holofloor/tiled{tag = "icon-steel_dirty"; icon_state = "steel_dirty"},/area/submap/MilitaryCamp1)
"H" = (/turf/simulated/floor/holofloor/tiled{tag = "icon-steel_dirty"; icon_state = "steel_dirty"},/area/submap/MilitaryCamp1)
"I" = (/obj/structure/table/standard,/obj/random/toolbox,/turf/simulated/floor/holofloor/tiled,/area/submap/MilitaryCamp1)
"J" = (/obj/structure/table/standard,/turf/simulated/floor/holofloor/tiled{tag = "icon-steel_broken4"; icon_state = "steel_broken4"},/area/submap/MilitaryCamp1)
"K" = (/turf/simulated/floor/holofloor/tiled{tag = "icon-steel_broken2"; icon_state = "steel_broken2"},/area/submap/MilitaryCamp1)
"L" = (/obj/machinery/light,/obj/structure/table/standard,/turf/simulated/floor/holofloor/tiled{tag = "icon-steel_dirty"; icon_state = "steel_dirty"},/area/submap/MilitaryCamp1)
"M" = (/obj/structure/table/standard,/turf/simulated/floor/holofloor/tiled{tag = "icon-steel_dirty"; icon_state = "steel_dirty"},/area/submap/MilitaryCamp1)
"N" = (/obj/machinery/door/airlock,/turf/simulated/floor,/area/submap/MilitaryCamp1)

(1,1,1) = {"
aaaaaaaaaaaaaaaaaaaa
abbcbdbefdbbbbbbbbba
acgcbbbbbbbfdbcgbbba
abccbbdbbhibbbccjhba
abhbbikklkkklkmcbbba
abbbbkkkllkkkkkbdbda
abbdkknoplokqrkkbeba
abbbkkslllotuvkkbbba
abbmkkkkkwokkkkxbdba
abbblkokyozAkokkbbba
afdblkoBCDoCBEkkbdba
abbbxkokkkkkkokxbFba
abbbkkwoooGHHHkkbbba
aFbbkkIJoKKHLMkkmbfa
abbebkkkkNlkkkkbdbba
abdbbbkkkllkkkbccdba
abcbbbbkkbmkkbjcbbba
acgcdbbbbdbibbcghbba
abccebdbhfbbdccbbbba
aaaaaaaaaaaaaaaaaaaa
"}
