"a" = (/turf/unsimulated/wall/void,/area/submap/banished_void)
"b" = (/obj/effect/landmark/banish_target,/turf/unsimulated/floor/void,/area/submap/banished_void)

(1,1,1) = {"
aaaaaaa
abababa
aaaaaaa
abababa
aaaaaaa
abababa
aaaaaaa
"}
