"a" = (/turf/unsimulated/wall/planetary/normal,/area/planets/Geminus/outdoor/vr/forest)
"b" = (/turf/simulated/mineral/impassable,/area/planets/Geminus/outdoor/vr/forest)
"c" = (/turf/simulated/floor/snow,/area/planets/Geminus/outdoor/vr/forest)
"d" = (/obj/structure/flora/tree/dead,/turf/simulated/floor/snow,/area/planets/Geminus/outdoor/vr/forest)
"e" = (/obj/structure/flora/tree/jungle_small,/turf/simulated/floor/snow,/area/planets/Geminus/outdoor/vr/forest)
"f" = (/obj/structure/flora/grass/brown,/turf/simulated/floor/snow,/area/planets/Geminus/outdoor/vr/forest)
"g" = (/obj/structure/closet/statue,/turf/simulated/floor/snow,/area/planets/Geminus/outdoor/vr/forest)
"h" = (/obj/structure/flora/tree/jungle,/turf/simulated/floor/snow,/area/planets/Geminus/outdoor/vr/forest)
"i" = (/obj/item/weapon/nullrod,/turf/simulated/floor/snow,/area/planets/Geminus/outdoor/vr/forest)
"j" = (/obj/structure/bonfire/permanent,/turf/simulated/floor/snow,/area/planets/Geminus/outdoor/vr/forest)
"k" = (/obj/structure/flora/rock,/turf/simulated/floor/snow,/area/planets/Geminus/outdoor/vr/forest)
"l" = (/obj/structure/flora/grass/green,/turf/simulated/floor/snow,/area/planets/Geminus/outdoor/vr/forest)
"m" = (/obj/structure/loot_pile/VR/weapon,/turf/simulated/floor/snow,/area/planets/Geminus/outdoor/vr/forest)
"n" = (/mob/living/simple_animal/hostile/statue{banishable = 1; view_range = 15},/turf/simulated/floor/snow,/area/planets/Geminus/outdoor/vr/forest)
"o" = (/obj/structure/flora/grass/both,/turf/simulated/floor/snow,/area/planets/Geminus/outdoor/vr/forest)
"p" = (/obj/effect/landmark/virtual_reality{name = "Bosnian Caves: 2324 - Remastered"},/turf/simulated/floor/snow,/area/planets/Geminus/outdoor/vr/forest)
"q" = (/obj/structure/loot_pile/VR/firstaid,/obj/structure/table/alien,/turf/simulated/floor/snow,/area/planets/Geminus/outdoor/vr/forest)
"r" = (/obj/structure/table/alien,/turf/simulated/floor/snow,/area/planets/Geminus/outdoor/vr/forest)
"s" = (/turf/unsimulated/wall/planetary/normal,/area/planets/Geminus/outdoor/vr)
"t" = (/obj/structure/loot_pile/VR/light,/obj/structure/table/alien,/turf/simulated/floor/snow,/area/planets/Geminus/outdoor/vr/forest)
"u" = (/turf/simulated/mineral,/area/planets/Geminus/outdoor/vr)
"w" = (/turf/simulated/mineral/floor,/area/planets/Geminus/outdoor/vr)
"x" = (/turf/simulated/floor/outdoors/grass,/area/planets/Geminus/outdoor/vr)
"y" = (/turf/simulated/floor/outdoors/grass/forest,/area/planets/Geminus/outdoor/vr)
"z" = (/turf/simulated/floor/outdoors/grass/nogrowth,/area/planets/Geminus/outdoor/vr)
"B" = (/obj/structure/loot_pile/VR/knife,/turf/simulated/floor/outdoors/grass/nogrowth,/area/planets/Geminus/outdoor/vr)
"C" = (/obj/structure/loot_pile/VR/light,/turf/simulated/floor/outdoors/grass/nogrowth,/area/planets/Geminus/outdoor/vr)
"D" = (/obj/effect/landmark/virtual_reality{name = "CaveCraft"},/obj/structure/bed,/turf/simulated/floor/outdoors/grass/nogrowth,/area/planets/Geminus/outdoor/vr)
"E" = (/obj/structure/bonfire/permanent,/turf/simulated/floor/outdoors/grass/nogrowth,/area/planets/Geminus/outdoor/vr)
"F" = (/turf/simulated/floor/water,/area/planets/Geminus/outdoor/vr)

(1,1,1) = {"
sssssssssssssssssssssssssssssssssssssssssssss
suuuuuuuuuuuuuuuuuuuuuuuuuuuuuuuuuuuuuuuuuuus
suuuuuwwwwwuuuxxxxyyyyuuuuuuuuuuuuuuuuxxuuuus
suuuuwwwwwwuuuxxxxyyyyyyyyuuuuuuuuuuuxxxzzuus
suuuuwwwwwwwuuuxxxyyyyyyyyyxxuuuuuuuxzzzBzzus
suuuuwwwwwwwuuuxyyyyyyyyyyyxxuuuuuuuxCzzzzDus
suuuuwwwwwwwuuxyyyyyyyyyyyyxxxxxuuuxxzzzEzzus
suuuwwwwwwwuuuxyyyyyyyyyyyyxxxxxxxuuxzzzzzuus
suuuuuwwwwuuuuxyyyyyyyyyyyyxxxxxxxxuuzzzuuuus
suuuuuuuuwuuuyyyyyyyyyxxxxxxxxxxxxxzzzzuuuuus
suuxxxuuuzzyyyyyyyyyyzzxxxxxxxzzzzzzzzzxxxxus
suuxxxxzzzzyyyyyyyyzzxxxxxzzzzzzzzzzzzxxxxxus
suuxxxxzzzzyyyyyyyyzzzzzzzzzzzzzzxzzxxxxxxxus
suuxxxxxxzzyyyyyyyyzzzzzzzzzzzzzzzxxxxxxxxxus
suuxxxxxxzzzzyyyzzzzzzzzzzzzzzyyyzzxxxxxxxxus
suuxxxxxxxzzzyyzzzzzzzzzzzzyyyyyyzzyyxxxxxxus
suuxxxxxxxzzzzzzzzzzyyyzzzzyyyyyyyyyyxxxxyyus
suuxxxxxxxxzzzzzyyyyyyyyyyyyyyyyyyyyyyyyyyyus
suuxxxxxxxxxxzzxxyyyyyyyyyyyyyyyyyyyyyyyyyyus
suuuxxxxxxxxxzzxxyyyyyyyyyyyyyyyyyyyyyyuuyyus
suuuxxxxxxxxxzzxxxxyyyyyyyyyyyyyyyyyyyyuuyyus
suuuxxxxxxxxxzzxxxxxxxxxyyyyyyyyyyyyyuuuuuuus
suuuuyyxxxxxzzzxxxxxxxxxyyyyyyyyyyyyyuuuuuuus
suuyyyyxxxxxzzxxxxxxxxxxxxxxyyyyyxxxxuyuuuuus
suuyyyxxxxxxzzxxxxxxxxxxxxxxxxxxxxxxxyyuuuuus
suuFyyzzzxxzzzxxxxxxxxxxxxxxxxxxxxxxxxxyyyuus
suuFFFzzzxzzzxxxxxxxxxxxxxxxxxxxxxxxxxxyyyyus
suuFFFzzzxzzxxxxxxxxxxyyyyyyxxxxxxxxxxxyyyyus
suuFFFzzzzzzzxxxxxxxxxyyyyyyxxxxxxxxxxxyyyyus
suuFFFFFzzzzzxxxyyyyyyyyyyyyxxxxxxxxxxxxxxxus
suuFFFFFFxzzzzzxyyyyyyyyyyyyyyxxxxxxxxxxxxxus
suuFFFFFFFxzzzzxyyyyyyyyyyyyyyxxxxxxxxxxxxxus
suuFFFFFFFFFFzzxuuyyyyyyyyyyyyxxxxxxxxxxxxuus
suuuFFFFFFFFFFuuuuuuyyyyyyyyyyyyyyxxxxxuuuuus
suuuuuuuuuuuuuuuuuuuuuuuuuuuuuuuuuuuuuuuuuuus
aaaaaaaaaaaaaaaaaaaaaaaaaaaaaaaaaaaaaaaaaaaaa
abbbbbbbbbbbbbbbbbbbbbbbbbbbbbbbbbbbbbbbbbbba
abbbbbbbbbbbbbbbccdccccccecccccfcccbbbbbbbbba
abcccdbbbbbbbbccccccccccccccccccccccccdgcbbba
abhcicbbbbbbbccccccccbbbbbbbbccccccccccccbbba
abbbcfcbbbbbbccjcfbbbbbbbbbbbbbbbbbckccchcbba
abbbbcccbbbccccccbbbbbbbbbcbbbbbbbbbbccjccbba
abbbbbccckbbbccccbbccccccccccccccdbbbbccccbba
abbbbbbccebbbcclbbccccccbbblccccccbbbmcfccbba
abbbbbbccbbbccccbbccjcbbbbbbbbbbccccccccccbba
abbbbbbccbbbccccbbccccbbbbbbbbbbbcccccceccbba
abbbbbbccbbbkccbbbccccccbbbbbbbbbbbbbcccccbba
abbbbccccbbcccebbbbbbccccbbbbbcbbbbbbbbbccdba
abbbdcccfccccccbbbbbbbbcccccccckbbbbbbbbcfcba
abbbccbbbbbbbcccbbbbbbbbbbbbbccccfccbbbbcccba
abbbcccbbbbbbccccbbbbbbbbbbbbbbbccccbbbccccba
abbbccbbbbbccccccccchcbbbcccbbbbbbbcbbbbcccba
abbbccbbbcccccbbcccccccccccccccdbbbcchbbccbba
abbcccbbbccfccbbbbbcccccccccjcccbbbccfccccbba
abbckbbbbcccccccdbbbbbbbbccccccccbbbbccldcbba
abbccbbbbcdcbccccbbbbbbbbbbdfccbbbbbbcceccbba
abccfchbbccbbbbbbbbbbbbbbbbbbbbbbbbbbcccccbba
abecmnbbbbbbbccbbbbbbbbbbbbbbbbbbcccfccccbbba
abbccbbbbbbbbcdcccccdbbbbbbchcccccclccdcbbbba
abbbbbbbbcdbbecclcckcccccccocccccccccccbbbbba
abbbbbbccfcbbbbcccccccceoccccccbbccccbbbbbbba
abbbbcdccoccbbbbbbbbccccccbbbbbbbccccbbbbbbba
abbbcccccccckcbbbbbbcccfcbbbbbbbdoccbbbbbbbba
abbbccccjcfccchcbbbbcccbbbbbbbceccccbbbbbbbba
abbbecfccccccccccccocccbbbdcoccccccbbbbbbbbba
abbbbbccccmcbbbfcccccccbbbcjcpccccbbbbbbbbbba
abbbbbbcccbbbbbccceccbbbbcocccccbbbbbbbbbbbba
abbbbbbbbbbbbbbbbbbbbbbbbbqrtbbbbbbbbbbbbbbba
abbbbbbbbbbbbbbbbbbbbbbbbbbbbbbbbbbbbbbbbbbba
aaaaaaaaaaaaaaaaaaaaaaaaaaaaaaaaaaaaaaaaaaaaa
"}
