"aa" = (/turf/simulated/floor/tiled/white,/area/space)
"ab" = (/turf/simulated/floor/tiled/steel_ridged,/area/space)
"aw" = (/obj/machinery/telecomms/allinone,/turf/simulated/floor/tiled/steel_grid,/area/space)
"aL" = (/obj/structure/prop/machine/tgmc_console3,/turf/simulated/floor/tiled/steel_ridged,/area/space)
"bg" = (/obj/structure/table/sifwoodentable,/turf/simulated/floor/tiled/steel,/area/space)
"bD" = (/turf/simulated/wall/shull,/area/space)
"cw" = (/obj/structure/fence/corner,/turf/simulated/floor/snow/snow2,/area/space)
"cZ" = (/obj/machinery/portable_atmospherics/canister/empty,/turf/simulated/floor/tiled/steel,/area/space)
"dB" = (/turf/simulated/floor/plating,/area/space)
"dX" = (/obj/structure/door_assembly/door_assembly_science,/turf/simulated/floor/tiled/steel,/area/space)
"ev" = (/obj/structure/fireaxecabinet{pixel_y = 32},/turf/simulated/floor/tiled/steel,/area/space)
"eA" = (/turf/simulated/floor/tiled/monofloor,/area/space)
"eN" = (/obj/structure/closet/secure_closet/personal,/turf/simulated/floor/tiled/steel,/area/space)
"gs" = (/turf/simulated/mineral,/area/space)
"gC" = (/obj/structure/fence/corner{dir = 4},/turf/simulated/floor/snow/snow2,/area/space)
"hi" = (/obj/machinery/door/window,/obj/machinery/door/window{dir = 8},/obj/structure/table/reinforced,/turf/simulated/floor/tiled/sif,/area/space)
"id" = (/obj/structure/prop/rock/watersharp,/turf/simulated/floor/water,/area/space)
"it" = (/obj/structure/prop/machine/tgmc_console4,/obj/machinery/atmospherics/pipe/simple/hidden/universal,/turf/simulated/floor/tiled/eris/techmaint_cargo,/area/space)
"iO" = (/obj/structure/bed/chair/sofa/beige/left,/turf/simulated/floor/tiled/steel,/area/space)
"jQ" = (/obj/structure/prop/rock/small/water,/turf/simulated/floor/water,/area/space)
"kf" = (/obj/structure/bed,/obj/item/weapon/bedsheet/brown,/turf/simulated/floor/tiled/steel,/area/space)
"kO" = (/turf/simulated/mineral/floor/sif,/area/space)
"mi" = (/obj/structure/prop/machine/comm_tower,/turf/simulated/floor/snow/snow2,/area/space)
"mo" = (/obj/structure/table/standard,/turf/simulated/floor/tiled/eris/cafe,/area/space)
"ny" = (/obj/structure/fence/corner{dir = 8},/turf/simulated/floor/snow/snow2,/area/space)
"oP" = (/turf/simulated/floor/water,/area/space)
"pZ" = (/obj/machinery/door/airlock/freezer,/turf/simulated/floor/tiled/steel_grid,/area/space)
"qa" = (/obj/structure/fence{dir = 8},/turf/simulated/floor/snow/snow2,/area/space)
"qg" = (/obj/structure/grille,/obj/structure/lattice,/turf/simulated/floor/water,/area/space)
"qq" = (/obj/structure/lattice,/turf/simulated/mineral/floor/sif,/area/space)
"qr" = (/turf/simulated/floor/tiled/eris/cafe,/area/space)
"sh" = (/obj/structure/disposalpipe/segment{dir = 8},/obj/machinery/atmospherics/pipe/simple/hidden/universal,/turf/simulated/floor/tiled/eris/techmaint_cargo,/area/space)
"us" = (/obj/machinery/door/blast/regular/open,/turf/simulated/floor/tiled/monofloor,/area/space)
"uN" = (/obj/structure/bed/chair/office/light{dir = 8},/turf/simulated/floor/tiled/sif,/area/space)
"vX" = (/obj/machinery/door/airlock/hatch,/turf/simulated/floor/tiled/steel,/area/space)
"xX" = (/obj/structure/prop/rock/small/alt,/turf/simulated/floor/snow/snow2,/area/space)
"ye" = (/turf/simulated/floor/snow/snow2,/area/space)
"zk" = (/obj/structure/disposalpipe/segment,/obj/effect/catwalk_plated/dark,/obj/structure/prop/machine/sorter,/turf/simulated/floor/water,/area/space)
"AX" = (/obj/machinery/door/airlock/maintenance/int,/turf/simulated/floor/tiled/steel,/area/space)
"BB" = (/turf/simulated/floor/tiled/eris/techmaint_cargo,/area/space)
"BH" = (/obj/structure/bed/chair/sofa/beige/right,/turf/simulated/floor/tiled/steel,/area/space)
"BI" = (/turf/simulated/floor/tiled/steel,/area/space)
"Cq" = (/obj/structure/disposalpipe/junction{dir = 8},/turf/simulated/floor/tiled/eris/techmaint_cargo,/area/space)
"Ct" = (/obj/structure/prop/rock/water,/turf/simulated/floor/water,/area/space)
"Cx" = (/turf/simulated/floor/tiled/steel_dirty,/area/space)
"CR" = (/obj/structure/fence/door/locked,/turf/simulated/floor/snow/snow2,/area/space)
"DI" = (/obj/machinery/atmospherics/pipe/simple/hidden/universal,/turf/simulated/floor/tiled/eris/techmaint_cargo,/area/space)
"DN" = (/turf/simulated/floor/tiled/monotile,/area/space)
"Ee" = (/obj/structure/table/rack,/turf/simulated/floor/tiled/steel_dirty,/area/space)
"Er" = (/obj/machinery/door/airlock/maintenance/command,/turf/simulated/floor/tiled/steel,/area/space)
"Fg" = (/obj/structure/table/standard,/obj/machinery/microwave/advanced,/turf/simulated/floor/tiled/eris/cafe,/area/space)
"FP" = (/turf/simulated/floor/tiled/techmaint,/area/space)
"Gv" = (/obj/machinery/door/blast/regular/open,/turf/simulated/floor/tiled/techmaint,/area/space)
"Gx" = (/turf/unsimulated/mineral,/area/space)
"Gz" = (/obj/structure/prop/rock/round,/turf/simulated/floor/snow/snow2,/area/space)
"Ha" = (/obj/machinery/door/airlock/maintenance/rnd,/turf/simulated/floor/tiled/steel,/area/space)
"HA" = (/obj/structure/bed/chair/office/light{dir = 1},/turf/simulated/floor/tiled/steel_ridged,/area/space)
"Ik" = (/obj/structure/fence/door/locked{dir = 8},/turf/simulated/floor/tiled/sif/planetuse,/area/space)
"Jw" = (/obj/structure/closet/crate/einstein,/turf/simulated/floor/tiled/steel_dirty,/area/space)
"Mb" = (/obj/structure/fence/corner{dir = 5},/turf/simulated/floor/snow/snow2,/area/space)
"Mh" = (/obj/structure/disposalpipe/segment,/obj/effect/catwalk_plated/dark,/turf/simulated/floor/water,/area/space)
"NG" = (/obj/structure/closet/secure_closet/freezer/fridge,/turf/simulated/floor/tiled/eris/cafe,/area/space)
"NP" = (/obj/machinery/appliance/cooker/oven,/turf/simulated/floor/tiled/eris/cafe,/area/space)
"Ol" = (/obj/structure/fence,/turf/simulated/floor/snow/snow2,/area/space)
"OS" = (/obj/machinery/door/airlock/freezer,/turf/simulated/floor/tiled/steel_ridged,/area/space)
"Qe" = (/obj/machinery/atmospherics/pipe/vent,/turf/simulated/floor/tiled/eris/techmaint_cargo,/area/space)
"QB" = (/obj/structure/flora/tree/sif,/turf/simulated/floor/snow/snow2,/area/space)
"QC" = (/obj/structure/table/bench/standard,/turf/simulated/floor/tiled/eris/cafe,/area/space)
"Sk" = (/turf/simulated/wall/r_wall,/area/space)
"SN" = (/obj/machinery/atmospherics/pipe/simple/visible{dir = 8},/turf/simulated/floor/plating,/area/space)
"SO" = (/turf/simulated/floor/outdoors/ice,/area/space)
"SW" = (/obj/machinery/vending/coffee{dir = 4},/turf/simulated/floor/tiled/steel,/area/space)
"SX" = (/obj/machinery/door/airlock/maintenance/sec,/turf/simulated/floor/tiled/sif,/area/space)
"Te" = (/obj/structure/prop/rock/small,/turf/simulated/floor/snow/snow2,/area/space)
"Tq" = (/obj/machinery/shower,/obj/structure/curtain/open/shower,/turf/simulated/floor/tiled/white,/area/space)
"TA" = (/obj/structure/prop/rock/flat,/turf/simulated/floor/snow/snow2,/area/space)
"TB" = (/obj/structure/lattice,/turf/simulated/floor/water,/area/space)
"TE" = (/obj/machinery/door/airlock/maintenance/sec,/turf/simulated/floor/tiled/steel,/area/space)
"TY" = (/obj/machinery/door/airlock/maintenance/engi,/turf/simulated/floor/plating,/area/space)
"Uc" = (/turf/simulated/floor/tiled/steel_grid,/area/space)
"Ug" = (/obj/structure/fence/cut/large{dir = 4},/turf/simulated/floor/snow/snow2,/area/space)
"Uq" = (/turf/simulated/floor/tiled/sif/planetuse,/area/space)
"Ut" = (/turf/simulated/floor/water/deep,/area/space)
"UU" = (/obj/structure/prop/machine/tgmc_console5,/turf/simulated/floor/tiled/steel_ridged,/area/space)
"Vv" = (/obj/structure/disposalpipe/segment{dir = 8},/turf/simulated/floor/tiled/eris/techmaint_cargo,/area/space)
"VF" = (/obj/structure/prop/machine/tgmc_console5,/obj/machinery/atmospherics/pipe/simple/hidden/universal,/turf/simulated/floor/tiled/eris/techmaint_cargo,/area/space)
"Wa" = (/obj/machinery/door/airlock/maintenance/engi,/turf/simulated/floor/tiled/sif,/area/space)
"We" = (/obj/effect/wingrille_spawn/reinforced,/turf/simulated/floor/tiled/sif,/area/space)
"WB" = (/obj/structure/sign/directions/telecomms{dir = 8},/turf/simulated/wall/r_wall,/area/space)
"WE" = (/turf/simulated/floor/tiled/sif,/area/space)
"WW" = (/obj/structure/table/rack/shelf/steel,/turf/simulated/floor/tiled/steel_dirty,/area/space)
"XW" = (/obj/structure/table/rack/shelf/steel,/turf/simulated/floor/tiled/steel_ridged,/area/space)
"Zq" = (/obj/structure/prop/machine/solifier,/obj/machinery/atmospherics/pipe/simple/visible{dir = 8},/turf/simulated/floor/plating,/area/space)
"Zt" = (/obj/machinery/atmospherics/pipe/vent,/turf/simulated/floor/tiled/white,/area/space)

(1,1,1) = {"
GxGxGxGxGxGxGxGxGxGxGxGxGxGxGxGxGxGxGxGxGxGxGxGxGxGxGxGxGxGxGxGxGxGxGxGxGxGxGxGxGxGxGxGxGxGxGxGxGxGxGxGxGxGxGxGxGxGxGxGxGxGxGxGxGxGxGxGxGxGxGxGxGxGxGxGxGxGxGxGxGxGxGxGxGxGxGxGxGxGxGxGxGxGxGxGxGxGxGxGx
GxgsgsgsgsgsgsgsgsgsgsgsgsgsgsgsgsgsgsgsgsgsgsgsgsgsgsSOSOSOSOSOSOSOSOSOSOSOSOSOSOSOSOSOSOoPoPoPoPoPoPoPoPoPoPoPoPSOSOSOSOSOSOSOSOSOSOSOSOSOSOgsgsgsgsgsgsgsgsgsgsgsgsgsgsgsgsgsgsgsgsgsgsgsgsgsgsgsgsGx
GxgsgsgsgsgsgsgsgsgsgsgsgsgsgsgsgsgsgsgsgsgsgsgsgsgsgsSOSOSOSOSOSOSOSOSOSOSOSOSOSOSOSOSOoPoPoPoPoPoPoPoPoPoPoPoPoPoPSOSOSOSOSOSOSOSOSOSOSOSOSOgsgsgsgsgsgsgsgsgsgsgsgsgsgsgsgsgsgsgsgsgsgsgsgsgsgsgsgsGx
GxgsgsgsgsgsgsgsgsgsgsgsgsgsgsgsgsgsgsgsgsgsgsgsgsgsgsSOSOSOSOSOSOSOSOSOSOSOSOSOSOSOSOSOSOoPoPoPoPoPoPoPoPoPoPoPoPoPSOSOSOSOSOSOSOSOSOSOSOSOSOgsgsgsgsgsgsgsgsgsgsgsgsgsgsgsgsgsgsgsgsgsgsgsgsgsgsgsgsGx
GxgsgsgsgsgsgsgsgsgsgsgsgsgsgsgsgsgsgsgsgsgsgsgsgsgsgsSOSOSOSOSOSOSOSOSOSOSOSOSOSOSOSOSOSOSOoPoPoPoPoPoPoPoPoPoPoPSOSOSOSOSOSOSOSOSOSOSOSOSOSOgsgsgsgsgsgsgsgsgsgsgsgsgsgsgsgsgsgsgsgsgsgsgsgsgsgsgsgsGx
GxgsgsgsgsgsgsgsgsgsgsgsgsgsgsgsgsgsgsgsgsgsgsgsgsgsgsSOSOSOSOSOSOSOSOSOSOSOSOSOSOSOSOSOSOSOoPoPoPoPoPoPoPoPoPoPoPSOSOSOSOSOSOSOSOSOSOSOSOSOSOgsgsgsgsgsgsgsgsgsgsgsgsgsgsgsgsgsgsgsgsgsgsgsgsgsgsgsgsGx
GxgsgsgsgsgsgsgsgsgsgsgsgsgsgsgsgsgsgsgsgsgsgsgsgsgsgsSOSOSOSOSOSOSOSOSOSOSOSOSOSOSOSOSOSOSOoPoPoPoPoPoPoPoPoPoPoPoPSOSOSOSOSOSOSOSOSOSOSOSOSOgsgsgsgsgsgsgsgsgsgsgsgsgsgsgsgsgsgsgsgsgsgsgsgsgsgsgsgsGx
GxgsgsgsgsgsgsgsgsgsgsgsgsgsgsgsgsgsgsgsgsgsgsgsgsgsgsSOSOSOSOSOSOSOSOSOSOSOSOSOSOSOSOSOSOoPoPoPoPoPoPoPoPoPoPoPoPoPSOSOSOSOSOSOSOSOSOSOSOSOSOgsgsgsgsgsgsgsgsgsgsgsgsgsgsgsgsgsgsgsgsgsgsgsgsgsgsgsgsGx
GxgsgsgsgsgsgsSkSkSkSkSkSkSkSkSkSkSkSkSkSkSkSkSkSkSkgsSOSOSOSOSOSOSOSOSOSOSOSOSOSOSOSOSOSOoPoPoPoPoPoPoPoPoPoPoPoPoPoPSOSOSOSOSOSOSOSOSOSOSOSOgsgsgsgsgsgsgsgsgsgsgsgsgsgsgsgsgsgsgsgsgsgsgsgsgsgsgsgsGx
GxgsgsgsgsgsgsSkQCQCQCQCqrBIBISkBIBIBIBIBIBIBIBIBISkgsSOSOSOSOSOSOSOSOSOSOSOSOSOSOSOSOSOoPoPoPoPoPoPoPoPoPoPoPoPoPoPSOSOSOSOSOSOSOSOSOSOSOSOSOgsgsgsgsgsgsgsgsgsgsgsgsgsgsgsgsgsgsgsgsgsgsgsgsgsgsgsgsGx
GxgsgsgsgsgsgsSkmomomomoqrBIBIAXBIBIBIBIBIBIBIBIBISkgsSOSOSOSOSOSOSOSOSOSOSOSOSOSOSOSOSOSOoPoPoPoPoPoPoPoPoPoPoPoPSOSOSOSOSOSOSOSOSOSOSOSOSOSOgsgsgsgsgsgsgsgsgsgsgsgsgsgsgsgsgsgsgsgsgsgsgsgsgsgsgsgsGx
GxgsgsgsgsgsgsSkQCQCQCQCqrBIBISkBIBIBIBIBIBIBIBIBISkgsSOSOSOSOSOSOSOSOSOSOSOSOSOSOSOSOSOoPoPoPoPoPoPoPoPoPoPoPoPSOSOSOSOSOSOSOSOSOSOSOSOSOSOSOgsgsgsgsgsgsgsgsgsgsgsgsgsgsgsgsgsgsgsgsgsgsgsgsgsgsgsgsGx
GxgsgsgsgsgsgsSkqrqrqrqrqrBIBISkSkSkSkSkSkSkBIBIBISkgsSOSOSOSOSOSOSOSOSOSOSOSOSOSOSOSOSOoPoPoPoPoPoPoPoPoPoPoPoPoPSOSOSOSOSOSOSOSOSOSOSOSOSOSOgsgsgsgsgsgsgsgsgsgsgsgsgsgsgsgsgsgsgsgsgsgsgsgsgsgsgsgsGx
GxgsgsgsgsgsgsSkQCQCQCQCqrBIBISkTqTqTqTqTqSkSkSkSkSkgsSOSOSOSOSOSOSOSOSOSOSOSOSOSOSOSOSOoPoPoPoPoPoPoPoPoPoPoPoPoPSOSOSOSOSOSOSOSOSOSOSOSOSOSOgsgsgsgsgsgsgsgsgsgsgsgsgsgsgsgsgsgsgsgsgsgsgsgsgsgsgsgsGx
GxgsgsgsgsgsgsSkmomomomoqrBIBISkaaaaaaaaaaSkBISkBISkgsSOSOSOSOSOSOSOSOSOSOSOSOSOSOoPoPoPoPoPoPoPoPoPoPoPoPoPoPoPoPoPSOSOSOSOSOSOSOSOSOSOSOSOSOgsgsgsgsgsgsgsgsgsgsgsgsgsgsgsgsgsgsgsgsgsgsgsgsgsgsgsgsGx
GxgsgsgsgsgsgsSkQCQCQCQCqrBIBISkaaaaZtaaaaSkBISkBISkgsSOSOSOSOSOSOSOSOSOSOSOSOSOoPoPoPoPoPoPoPoPoPoPoPoPoPoPoPoPoPoPSOSOSOSOSOSOSOSOSOSOSOSOSOgsgsgsgsgsgsgsgsgsgsgsgsgsgsgsgsgsgsgsgsgsgsgsgsgsgsgsgsGx
GxgsgsgsgsgsgsSkqrqrqrqrqrBIBISkaaSkSkSkaaSkBIBIBISkgsSOSOSOSOSOSOSOSOSOSOSOSOSOoPoPoPoPoPoPoPoPoPoPoPoPoPoPoPoPoPoPSOSOSOSOSOSOSOSOSOSOSOSOSOgsgsgsgsgsgsgsgsgsgsgsgsgsgsgsgsgsgsgsgsgsgsgsgsgsgsgsgsGx
GxgsgsgsgsgsgsSkmomomomoSkBIBISkaaaaaaaaaaSkBIBIBISkgsSOSOSOSOSOSOSOSOSOSOSOSOoPoPoPoPoPoPoPoPoPoPoPoPoPoPoPoPoPoPSOSOSOSOSOSOSOSOSOSOSOSOSOSOgsgsgsgsgsgsgsgsgsgsgsgsgsgsgsgsgsgsgsgsgsgsgsgsgsgsgsgsGx
GxgsgsgsgsgsgsSkqrqrqrmoSkBIBISkSkSkBISkSkSkSkAXSkSkgsSOSOSOSOSOSOSOSOSOSOoPoPoPoPoPoPoPoPoPoPoPoPoPoPoPoPoPoPoPoPSOSOSOSOSOSOSOSOSOSOSOSOSOSOgsgsgsgsgsgsgsgsgsgsgsgsgsgsgsgsgsgsgsgsgsgsgsgsgsgsgsgsGx
GxgsgsgsgsgsgsSkNGqrqrNPSkBIBIBIBIBIBIBIBIBIBIBISkgsgsSOSOSOSOSOSOSOSOoPoPoPoPoPoPoPoPoPoPoPoPoPoPoPoPoPoPoPoPoPoPoPSOSOSOSOSOSOSOSOSOSOSOSOSOgsgsgsgsgsgsgsgsgsgsgsgsgsgsgsgsgsgsgsgsgsgsgsgsgsgsgsgsGx
GxgsgsgsgsgsgsSkmoFgqrqrAXBIBIBIBIBIBIBIBIBIBIBISkgsgsSOSOSOSOSOSOSOSOSOoPoPoPoPoPoPoPoPoPoPoPoPoPoPoPoPoPoPoPoPoPoPSOSOSOSOSOSOSOSOSOSOSOSOSOgsgsSkSkSkSkSkSkSkSkSkgsgsgsgsgsgsgsgsgsgsgsgsgsgsgsgsgsGx
GxgsgsgsgsgsgsSkSkSkSkSkSkSkSkSkSkSkSkSkBIBISkSkSkgsgsSOSOSOSOSOSOSOSOoPoPoPoPoPoPoPSkSkSkSkSkSkSkSkSkSkSkSkSkSkSOSOSOSOSOSOSOSOSOSOSOSOSOSOSOgsgsSkBIBIBIBIBIBIBISkgsgsgsgsgsgsgsgsgsgsgsgsgsgsgsgsgsGx
GxgsgsgsgsgsgsgsgsgsgsgsgsgsgsgsgsgsgsSkBIBISkgsgsgsgsSOSOSOSOyeyeyeyeoPoPSkSkSkSkSkSkCqshshVvVvVvVvVvshshVvCqSkSkSkSkSkSOSOSOSOyeyeyeSOSOSOyegsgsSkBIBIBIBIBIBIBISkgsgsgsgsgsgsgsgsgsgsgsgsgsgsgsgsgsGx
GxgsgsgsgsgsgsgsgsgsgsgsgsgsgsgsgsgsSkSkBIBISkSkgsgsgsSOSOyeyeyeSkSkSkSkSkSkBBBBDIDIBBBBDIDIBBBBBBBBBBDIDIBBBBDIDIBBBBSkSkSkSkSkSkyeyeyeyeyeyegsgsSkBIBIBIBIBIBIBISkgsgsgsgsgsgsgsgsgsgsgsgsgsgsgsgsgsGx
GxgsgsgsgsgsgsgsgsgsgsgsgsgsgsgsgsgsSkBIBIBIBISkSkSkSkSkSkSkSkSkSkBBBBBBBBBBBBBBDIDIBBBBDIDIBBBBBBBBBBDIDIBBBBDIDIBBBBBBBBBBBBBBSkSkSkSkSkSkSkSkSkSkSkDNSkSkSkSkSkSkgsgsgsgsgsgsgsgsgsgsgsgsgsgsgsgsgsGx
GxgsgsgsgsgsgsgsgsgsgsgsgsgsgsgsgsgsSkBIBIBIBISkBBBBBBBBBBBBBBBBBBBBBBBBBBBBBBBBDIDIBBBBDIDIBBBBBBBBBBDIDIBBBBDIDIBBBBBBBBBBBBBBBBBBBBBBBBBBBBSkFPFPFPDNFPFPFPFPSkgsgsgsgsgsgsgsgsgsgsgsgsgsgsgsgsgsgsGx
GxgsgsgsgsgsgsgsgsgsgsgsgsgsgsgsgsgsSkBIBIBIBIBBBBBBBBBBBBBBBBBBBBBBBBBBBBBBQeBBDIDISkSkSkSkSkSkTYSkSkSkSkSkSkVFitBBBBBBBBBBBBBBBBBBBBBBBBBBBBBBDNDNDNDNDNDNDNFPSkgsgsgsgsgsgsgsgsgsgsgsgsgsgsgsgsgsgsGx
GxgsgsgsgsgsgsgsgsgsgsgsgsgsgsgsgsgsSkBIBIBIBIBBBBBBBBBBBBBBBBBBBBBBBBBBBBSkSkTYSkSkSkSNzkzkZqSNSNSNSNzkzkZqSkSkSkTYSkSkBBBBBBQeBBBBBBBBBBBBBBBBDNDNDNDNDNDNDNFPSkgsgsgsgsgsgsgsgsgsgsgsgsgsgsgsgsgsgsGx
GxgsgsgsgsgsgsgsgsgsgsgsgsgsgsgsgsgsSkBIBIBIBISkBBQeBBBBBBBBBBBBSkSkSkSkSkSkdBdBzkzkSkdBMhMhdBdBdBdBdBMhMhdBSkzkzkdBdBSkSkSkSkSkSkBBBBBBBBBBBBSkFPFPDNDNDNDNDNFPSkgsgsgsgsgsgsgsgsgsgsgsgsgsgsgsgsgsgsGx
GxgsgsgsgsgsgsSkSkSkSkSkSkgsgsgsgsgsSkBIBIBIBISkSkSkSkSkSkSkSkSkSkdBdBdBdBdBdBdBMhMhSkdBTBTBdBdBdBdBdBTBTBdBSkMhMhdBdBdBdBdBdBdBSkSkSkSkSkSkSkSkSkFPDNeADNDNDNFPSkgsgsgsgsgsgsgsgsgsgsgsgsgsgsgsgsgsgsGx
GxgsgsgsgsgsgsSkBIBIBIBISkgsgsgsgsgsSkBIBIBIBIBIBIBIBIevBIBIBIBISkdBdBdBdBdBdBdBTBTBSkSkqgqgSkSkSkSkSkqgqgSkSkTBTBdBdBdBdBdBdBdBSkBIBIBIBIBIBIBISkFPDNDNDNDNDNFPSkgsgsgsgsgsgsgsgsgsgsgsgsgsgsgsgsgsgsGx
GxgsgsgsgsgsgsSkBIBIBIBISkgsgsgsgsgsSkBIBIBIBIBIBIBIBIBIBIBIBIBISkdBdBdBdBSkSkSkqgqgSkUtUtUtUtUtUtUtUtUtUtUtSkqgqgSkSkSkdBdBdBdBSkBIBIBIBIBIBIBIWaFPDNDNDNDNDNFPSkgsgsgsgsgsgsgsgsgsgsgsgsgsgsgsgsgsgsGx
GxgsgsgsgsgsgsSkBIBIBIBISkgsgsgsgsgsSkBIBIBIBIBIBIBIBIBIBIBIBIBISkSkSkSkSkSkoPoPoPoPoPUtUtUtUtUtUtUtUtUtUtUtoPoPoPoPoPSkSkSkSkSkSkBIBIBIBIBIBIBISkFPFPFPFPFPDNFPSkgsgsgsgsgsgsgsgsgsgsgsgsgsgsgsgsgsgsGx
GxgsgsgsgsgsgsSkBIBIBIBISkgsgsgsgsgsSkSkBIBISkSkSkSkSkSkSkSkSkSkSkyeyeyeyeyeoPoPoPoPoPoPUtUtUtUtUtUtUtUtUtoPoPoPoPoPoPyeyeyeyeyeSkSkSkSkSkSkSkSkSkSkSkSkSkFPDNFPSkgsgsgsgsgsgsgsgsgsgsgsgsgsgsgsgsgsgsGx
GxgsgsgsgsgsgsSkBIBIBIBISkgsgsgsgsgsgsSkBIBISkgsgsgsgsgsyeyeyeyeyeyeyeyeyeyeoPoPoPoPoPoPUtUtUtUtUtUtUtUtUtoPoPoPoPoPoPyeyeyeyeyeyeyeyeyeyeyegsgsgsgsgsgsSkFPDNFPSkgsgsgsgsgsgsgsgsgsgsgsgsgsgsgsgsgsgsGx
GxgsgsgsgsgsgsSkSkSkHaSkSkgsgsgsgsgsgsSkBIBISkgsgsgsgsgsyeyeyeyeyeyeyeyeyeyeyeyeyeyeyeyeoPUtUtUtUtUtUtUtoPyeyeyeyeyeyeyeyeyeyeyeyeyeyeyeyeyegsgsgsgsgsgsSkFPDNFPSkgsgsgsgsgsgsgsgsgsgsgsgsgsgsgsgsgsgsGx
GxgsgsgsgsgsgsSkSkBIBIBISkSkSkSkSkSkSkSkBIBISkgsgsgsgsgsyeyeyeyeyeyeyeyeyeyeyeyeyeyeyeyeoPoPUtUtUtUtUtUtoPyeyeyeyeyeyeyeyeyeyeyeyeyeyeyeyeyegsgsgsgsgsgsSkFPDNFPSkgsgsgsgsgsgsgsgsgsgsgsgsgsgsgsgsgsgsGx
GxgsgsgsgsgsgsSkBIBIBIBIBIBIBIBIBIBIBIBIBIBISkgsgsgsgsgsyeyexXyeyeyeyeyeyeyeyeyeyeyeyeyeoPoPoPUtUtUtUtoPoPyeyeyeyeyeyeyeyeyeyeyeyeyeyeyeyeyegsgsgsgsgsgsSkFPDNFPSkSkSkSkSkSkSkSkSkSkSkgsgsgsgsgsgsgsgsGx
GxgsgsgsgsgsgsSkBIBIBIBIBIBIBIBIBIBIBIBIBIBISkgsgsgsgsgsyeyeyeyeyeyeyeyeyeyeyeyeyeyeyeyeoPoPoPoPUtoPoPoPoPyeyeyeyeyeyeyeyeyeyeyeyeyeyeyeyeyegsgsgsgsgsgsSkFPDNFPFPFPFPFPFPFPFPFPFPFPSkgsgsgsgsgsgsgsgsGx
GxgsgsgsgsgsgsSkSkErSkSkSkSkSkSkSkSkSkSkSkSkSkgsgsgsgsgsyeyeyeyeyeyeyeyeyeyeyeyeyeyeyeyeoPoPoPoPoPoPoPoPjQyeyeyeyeyeyeTeyeyeyeyeyeyeyeyeyeyegsgsgsgsgsgsSkFPDNDNDNDNDNDNDNDNDNDNDNFPSkgsgsgsgsgsgsgsgsGx
GxgsgsgsgsgsgsSkBIBIBISkBIBIBISkBIBIBIBISkgsgsgsgsgsgsgsyeyeyeyeyeyeyeyeyeyeyeyeyeyeyeyeoPoPoPoPoPoPoPoPoPyeyeyeyeyeyeyeyeyeyeyeyeyeyeyeyeyegsgsgsgsgsgsSkFPFPFPFPFPFPFPFPFPFPFPDNFPSkgsgsgsgsgsgsgsgsGx
GxgsgsgsgsgsgsSkBIBIBIBIBIBIBISkBIBIBIBISkgsgsgsgsgsgsgsyeyeyeyeyeyeyeyeyeyeyeyeyeyeyeyeoPoPoPoPoPoPoPoPoPyeyeyeyeyeyeyeyeyeyeyeyeyeyeyeyeyegsgsgsgsgsgsSkSkSkSkSkSkSkSkSkSkSkFPDNFPSkgsgsgsgsgsgsgsgsGx
GxgsgsgsgsgsgsSkBIBIBISkBIBIBISkBIBIBIBISkgsgsgsgsgsgsgsyeyeyeyeyeyeyeyeyeyeyeyeyeyeyeyeoPoPoPoPoPoPoPoPoPyeyeyeyeyeyeyeyeyeyeyeyeyeyeyeyeyegsgsgsgsgsgsgsSkWEWEWEWEWEWEWEWESkFPDNFPSkgsgsgsgsgsgsgsgsGx
GxgsgsgsgsgsgsSkSkErSkSkBIBIBITEBIBIBIBISkgsgsgsgsgsgsgsyeyeyeyeyeyeyeyeyeyeyeyeyeyeyeyeCtoPoPoPoPoPoPoPoPyeyeyeyeyeyeyeyeyeyeyeyeyeyeyeyeyegsgsgsgsgsgsgsSkWEWEWEWEWEWEWEWEWEUcDNFPSkgsgsgsgsgsgsgsgsGx
GxgsgsgsgsgsgsSkBIBIBISkBIBIBISkBIBIBIBISkgsgsgsgsgsgsgsyeyeyeyeyeTeyeyeyeyeyeyeyeyeyeyejQoPoPoPoPoPoPoPoPyeyeyeyeyeyeyeyeyeyeyeyeyeyeyeyeyegsgsgsgsgsgsgsSkWEWEWEWEWEWEWEWESkFPDNFPSkgsgsgsgsgsgsgsgsGx
GxgsgsgsgsgsgsSkBIBIBITEBIBIBISkBIBIBIBISkgsgsgsgsgsgsgsyeyeyeyeyeyeyeyeyeyeyeyeyeyeyeyeoPoPoPoPoPoPoPoPoPyeyeyeyeyeyeyeyeyeyeyeTAyeyeyeyeyegsgsgsgsgsgsSkSkSkSkSkSkSkSkSkSkSkFPDNFPSkgsgsgsgsgsgsgsgsGx
GxgsgsgsgsgsgsSkBIBIBISkBIBIBISkBIBIBIBISkgsgsgsgsgsgsgsyeyeyeyeyeyeyeyeyeyeyeyeyeyeyeyeoPoPoPoPoPoPoPoPoPyeyeyeyeyeQByeyeyeyeyeyeyeyeyeyeyegsgsgsgsgsgsSkFPFPFPFPFPFPFPFPFPFPFPDNFPSkgsgsgsgsgsgsgsgsGx
GxgsgsgsgsgsgsSkBIBIBISkSkSkSkSkSkSkSkSkSkgsgsgsgsgsgsgsyeyeyeyeyeyeyeyeyeyeyeyeyeyeyeyeoPoPoPoPjQoPoPoPoPyeyeyeyeyeyeyeyeyeyeyeyeyeyeyeyeyegsgsgsgsgsgsSkFPDNDNDNDNDNDNDNDNDNDNDNFPSkgsgsgsgsgsgsgsgsGx
GxgsgsgsgsgsgsSkBIBIBISkgsgsgsgsgsgsgsgsgsgsgsgsgsgsgsgsyeyeyeyeyeyeyeyeyeyeyeyeyeyeyeyeoPoPoPoPoPoPoPoPoPyeyeyeyeyeyeyeyeyeyeyeyeyeyeyeyeyegsgsgsgsgsgsSkFPDNFPFPFPFPFPFPFPFPFPFPFPSkgsgsgsgsgsgsgsgsGx
GxgsgsgsgsgsgsSkBIBIBISkgsgsgsgsgsgsgsgsgsgsgsgsgsgsgsgsyeyeyeyeyeyeyeyeyeyexXyeyeyeyeyeoPoPoPoPoPoPoPoPoPyeyeyeyeyeyeyeyeyeyeyeyeyeyeyeyeyegsgsgsgsgsgsSkFPDNFPSkSkSkSkSkSkSkSkSkSkSkgsgsgsgsgsgsgsgsGx
GxgsgsgsgsgsgsSkBIBIBISkSkSkSkSkSkgsgsgsgsgsgsgsgsgsgsgsyeyeyeyeyeyeyeyeyeyeyeyeyeyeyeyeoPoPoPoPoPoPoPoPoPyeyeyeyeyeyeyeyeyeyeyeyeyeyeyeyeyegsgsgsgsgsgsSkFPDNFPSkgsgsgsgsgsgsgsgsgsgsgsgsgsgsgsgsgsgsGx
GxgsgsgsgsgsgsSkBIBIBISkBIBIBIBISkgsgsgsgsgsgsgsgsgsgsgsyeyeyeyeyeyeyeyeyeyeyeyeyeyeyeyeoPoPoPoPoPoPoPoPoPyeyeyeyeyeyeyeyeyeyeyeyeQByeyeyeyegsgsSkSkSkSkSkFPDNFPSkSkSkSkgsgsgsgsgsgsgsgsgsgsgsgsgsgsgsGx
GxgsgsgsgsgsgsSkBIBIBIvXBIBIBIBISkgsgsgsgsgsgsgsgsgsgsgsyeyeyeyeyeyeyeyeyeyeyeyeyeyeyeyeoPoPoPoPoPoPoPoPoPyeyeyeyeyeyeyeyeQByeyeyeyeyeyeyeyegsgsSkFPFPFPFPFPDNFPWeWEWESkgsgsgsgsgsgsgsgsgsgsgsgsgsgsgsGx
GxgsgsgsgsgsgsSkBIBIBISkBIBIBIBISkgsgsgsgsgsgsgsgsgsgsgsyeyeyeyeyeyeyeyeyeyeyeyeyeyeyeyeoPoPoPoPoPoPoPoPidyeyeyeQByeyeyeyeyeyeyeyeyeyeyeyeyegsgsSkFPDNDNDNDNDNFPhiuNWESkgsgsgsgsgsgsgsgsgsgsgsgsgsgsgsGx
GxgsgsgsgsgsgsSkBIBIBISkSkSkSkSkSkgsgsgsgsgsgsgsgsgsgsgsyeyeyeyeyeyeyeyeyeyeyeyeyeyeyeyeoPoPoPoPoPoPoPoPoPyeyeyeyeyeyeyeyeyeyeyeyeyeyeyeyeyegsgsSkFPDNFPFPFPUcUcSXWEWESkgsgsgsgsgsgsgsgsgsgsgsgsgsgsgsGx
GxgsgsgsgsgsgsSkBIBIBISkSkSkSkSkSkgsgsgsgsgsgsgsyeyeyeyeyeyeyeyeyeyeyeyeyeyeyeyeyeyeyeyejQoPoPoPoPoPoPoPoPyeyeyeyeyeyeyeyeyeyeyeyeyeyeyeyeyegsgsSkFPDNFPSkSkSkSkSkSkSkSkgsgsgsgsgsgsgsgsgsgsgsgsgsgsgsGx
GxgsgsgsgsgsgsSkBIBIBISkBIBIBIBISkgsgsgsgsgsgsgsyeyeyeyeyeyeyeyeyeyeyeyeyeyeyeyeyeyeyeyeoPoPoPoPoPoPoPoPoPyeyeyeyeyeyeyeyeyeyeyeyeTeyeyeyeyegsgsSkGvusGvSkgsgsgsgsgsgsgsgsgsgsgsgsgsgsgsgsgsgsgsgsgsgsGx
GxgsgsgsgsgsgsSkBIBIBIvXBIBIBIBISkgsgsgsgsgsgsgsyeyeyeyeyeQByeyeyeyeyeyeyeyeQByeyeyeyeyeoPoPoPoPoPoPoPoPoPyeyeyeyeyeyeyeyeyeyeyeyeyeyeyeyeyeyeyeSkUqUqUqSkyeyeyeyeyeyeyeyeyeyeyeyeyeyeyeyeyeyeyeyeyeyeGx
GxgsgsgsgsgsgsSkBIBIBISkBIBIBIBISkgsgsgsgsgsgsgsyeyeyeyeyeyeyeyeyeyeyeyeyeyeyeyeyeyeyeyeoPoPoPoPoPoPoPoPoPyenyqaqaqaqaqaCRqaqaqaqaqaqaqaqaqaqaqaSkUqUqUqSkyeyeyeyeyeyeyeyeyeSkSkSkSkSkSkSkSkyeyeyeyeyeGx
GxgsgsgsgsgsgsSkBIBIBISkBIBIBIBISkgsgsgsgsgsgsgsyeyeyeyeyeyeyeyeyeyeyeyeyeyeyeyeyeyeyeyeoPoPoPoPoPoPoPoPoPyeOlyeyeyeyeyeUqyeyeyeyeyeyeyeyeyeyeyeyeUqUqUqyeyeyeyeyeyeyeyeyeyeSkeNeNeNeNbgbgSkyeyeyeyeyeGx
GxgsgsgsgsgsSkSkBIBIBISkBIBIBIBISkgsgsgsgsgsgsgsyeyeyeyeyeyeyeyeyeyeyeyeyeyeyeyeyeyeyeyeoPidoPoPoPoPoPoPoPyeOlyeyeyeyeyeUqyeyeyeyeyeyeyeyeyeyeyeyeUqUqUqyeyeyeSkSkSkSkSkyeyeSkBIBIBIBIBIBIpZUqUqyeyeyeGx
GxgsgsgsgsgsSkBIBIBIBISkBIBIBIBISkgsgsgsgsgsgsgsyeyeyexXyeyeyeyeyeyeyeyeyeyeyeyeGzyeyeyeoPoPoPoPoPoPoPoPoPyeOlyeyeyeyeyeUqUqUqUqUqUqUqUqUqUqUqUqUqUqUqUqyeyeyeSkWWEeEeSkyeyeSkBIBIBIBIBIBISkUqUqyeyeyeGx
GxgsgsgsgsgsSkBIBIBIBISkBIBIBIBISkgsgsgsgsgsgsgsyeyeyeyeyeyeyeyeyeyeyeQByeyeyeyeyeyeyeyeoPoPoPoPoPoPoPoPoPyeOlyeyeyeyeyeyeyeyeyeyeyeyeyeyeyeyeyeyeUqUqUqyeyeyeSkCxUcUcpZUqyeSkBICxBIBIBIBISkUqUqyeyeyeGx
GxgsgsgsgsgsSkBIBIBIBISkSkSkSkSkSkgsgsgsgsgsgsgsyeyeyeyeyeyeyeyeyeyeyeyeyeyeyeyeyeyeyeyeoPoPoPoPoPoPoPoPoPyeOlyeyeyeyeyeyeyeyeyeyeyeyeyeyeyeyeyeyeUqUqUqUqUqUqSkJwEeEeSkUqyeSkbgkfbgkfbgkfSkUqUqyeyeyeGx
GxgsgsgsgsgsSkSkBIBIBISkSkSkSkSkSkgsgsgsgsgsgsgsyeQByeyeyeyeyeyeyeyeyeyeyeyeyeyeyeyeyeyeoPoPoPoPoPoPoPoPoPyeOlyeyeyeyeyeyeyeyeyeyeyeyeyeyeyeyeyeyeUqUqUqUqUqUqSkSkSkSkSkUqyeSkSkSkSkSkSkSkSkUqUqyeyeyeGx
GxgsgsgsgsgsgsSkBIBIBISkBIBIBIBISkgsgsgsgsgsgsgsyeyeyeyeyeyeyeyeyeyeyeyeyeyeyeyeyeyeyeyeoPoPoPoPoPoPoPoPoPyeOlyeyeyeQByeyeyeyeyeyeQByeyeyeyeyeyeyeyeyeyeyeUqUqUqUqUqUqUqUqUqUqUqUqUqUqUqUqUqUqUqyeyeyeGx
GxgsgsgsgsgsgsSkBIBIBIvXBIBIBIBISkgsgsgsgsgsgsgsqaqaqaqaqaqaqaqaqaUgqaqaqaqaqaqaqagCyeyeoPoPoPoPoPoPoPoPoPyeOlyeyeyeyeyeyeyeyeyeyeyeyeyeyeyeyeyeyeyeyeyeyeUqUqUqUqUqUqUqUqUqUqUqUqUqUqUqUqUqUqUqUqUqyeGx
GxgsgsgsgsgsgsSkBIBIBISkBIBIBIBISkgsgsgsgsgsgsgsyeyeyeyeyeyeyeyeyeyeyeyeyeyeyeyeyeOlyeyeoPoPoPoPoPoPoPoPoPyeOlyeyeyeyeyeyeyeyeyeyeyeyeyeyeyeyeyeyeyeyeyeyeyeyeyeyeyeUqUqSkSkSkSkSkyeyeyeSkSkSkSkSkUqyeGx
GxgsgsgsgsgsgsSkBIBIBISkSkSkSkSkSkgsgsgsgsgsgsgsyeyeyeyeyeyeyeyeyeyeyeyeyeyeyeyeyeOlyeyeoPoPoPoPoPoPoPoPoPyeOlyeyeyeyeyeyeyeyeyeyeyeyeyeyeyeyeyeyeyeyeyeyeSkSkSkSkSkUqUqSkcZBHiOSkyeyeyeSkXWXWXWSkUqyeGx
GxgsgsgsgsgsgsSkBIBIBISkgsgsgsgsgsgsgsgsgsgsgsgsyeyeyeyeyeyeyeyeyeyeyeyeyeyeyeyeyeOlyeyeoPoPoPoPoPoPoPoPoPyeOlyeyeyeyeyeyeyeyeyeyeyeyeyeyeyeyeyeQByeyeyeyeSkaLUUUUSkUqUqpZBIBIBISkyeyeyeSkabababOSUqyeGx
GxgsgsgsgsgsgsSkBIBIBISkSkSkSkSkSkSkSkSkSkSkSkSkyeyeyeyeSkSkSkSkSkSkSkSkSkSkyeyeyeOlyeyeoPoPoPoPoPoPoPoPoPyeOlyeyeyeyeyeyeyeyeyeyeyeyeyeyeyeyeyeyeyeyeyeyeSkHABIabSkUqUqSkSWBICxSkyeyeyeSkabababSkyeyeGx
GxgsgsgsgsgsgsSkBIBIBIdXBIBIBIBIBIBIBIBIBIBIBIBIUqUqUqyeSkBIBIBISkBIBIBIBISkyeyeyeOlQByeoPoPoPoPoPoPoPoPoPyeOlyeyeyeyeyeyeyeQByeyeyeyeyeyeyeyeyeyeyeyeyeyeSkUcBIUcSkUqUqSkSkSkSkSkyeyeyeSkSkSkSkSkyeyeGx
GxgsgsgsgsgsgsSkBIBIBISkSkSkSkSkSkSkSkSkSkSkSkSkyeyeUqyeSkBIBIBISkBIBIBIBISkyeyeyeOlyeyeoPoPoPoPoPoPoPoPoPyeOlyeyeyeyeyeyeyeyeyeyeyeyeyeyeyeyeyeyeyeyeyeyeSkUcBIUcSkUqUqyeyeyeyeyeyeyeyeyeyeyeyeyeyeyeGx
GxgsgsgsgsgsgsSkBIBIBISkgsgsgsgsgsgsgsgsgsgsgsgsyeyeUqyeSkBIBIBIBIBIBIBIBISkyeyeyeOlyeyeoPoPoPoPoPoPoPoPoPyeOlyeyeyeyeyeyeyeyeyeyeyeyenyqaqaqaMbyeyeyeyeyeSkawBIUcSkUqUqyeyeyeyeyeyeyeyeyeyeyeyeyeyeyeGx
GxgsgsgsgsgsgsSkBIBIBISkSkSkSkSkSkgsgsgsgsgsgsgsyeyeUqyeSkBIBIBISkBIBIBIBISkyeyeyeOlyeyeoPoPoPoPoPoPoPoPoPyeOlyeyeyeyeyeyeyeyeyeyeyeyeOlUqUqUqOlyeyeyeyeyeSkSkpZWBSkUqUqyeyeyeyeyeyeyeyeyeyeyeyeyeyeyeGx
GxgsgsgsgsgsgsSkBIBIBIBIBIBIBIBISkgsgsgsgsgsgsgsyeyeUqyeSkBIBIBISkSkSkSkSkSkyeyeyeOlyeyeoPoPoPoPoPoPoPoPoPyeOlyeyeyeyeyeyeyeyeyeyeyeyeOlUqmiUqIkUqUqUqUqUqUqUqUqUqUqUqUqyeyeyeyeyeyeyeyeyeyeyeyeyeyeyeGx
GxgsgsgsgsgsgsSkBIBIBIBIBIBIBIBISkgsgsgsgsgsgsgsyeyeUqyeSkBIBIBISkBIBIBIBISkyeyeyeOlyeyeoPoPoPoPoPoPoPoPoPyeOlyeyeyeyeyeyeyeyeyeyeyeyeOlUqUqUqOlyeyeyeyeyeyeyeyeyeyeUqUqyeyeyeyeyeyeyeyeyeyeyeyeyeyeyeGx
GxgsgsgsgsgsgsSkSkSkSkSkSkSkBIBISkgsgsgsgsgsgsgsyeyeUqyeSkBIBIBISkBIBIBIBISkyeyeyeOlyeyeoPoPoPoPoPoPoPoPoPyeOlyeyeyeyeyeyeyeyeyeyeyeyenyqaqaqacwyeyeyeyeyeyeyeyeyeyeUqUqyeyebDbDbDyeyeyeyeyeyeyeyeyeyeGx
GxgsgsgsgsgsgsgsgsgsgsgsgsSkBIBISkgsgsgsgsgsgsgsyeyeUqyeSkBIBIBIBIBIBIBIBISkyeyeyeOlyeyeoPoPoPoPoPoPoPoPoPyeOlyeyeyeyeyeyeTeyeyeyeyeyeyeyeyeyeyeyeyeyeyeyeyeyeyeyeyeUqUqyeyeyeyeyeyeyeyeyeyeQByeyeyeyeGx
GxgsgsgsgsgsgsgsgsgsgsgsgsSkBIBISkgsgsgsgsgsgsgsyeyeUqyeSkBIBIBISkBIBIBIBISkyeyeyeOlyeyeoPoPoPoPoPoPoPoPoPyeOlyeyeyeyeyeyeyeyeyeyeyeyeyeyeyeyeyeyeyeyeyeyeyeyeyeyeyeUqUqyeyeyeyeyeyeyeyeyeyeyeyeyeyeyeGx
GxgsgsgsgsgsgsSkSkSkSkSkSkSkBIBISkgsgsgsgsgsgsgsyeyeUqyeSkBIBIBISkSkSkSkSkSkyeyeyeOlyeyeoPoPoPoPoPoPoPoPoPyeOlyeyeyeyeyeyeyeyeyeyeyeyeyeyeyeyeyeyeyeyeyeyeyeyeyeyeyeUqUqyeyeyeyeyeyeyeyeyeyeyeyeyeyeyeGx
GxgsgsgsgsgsgsSkBIBIBIBIBIBIBIBISkgsgsgsgsgsgsgsyeyeUqyeSkBIBIBISkBIBIBIBISkyeyeyeOlyeyeoPoPoPoPoPoPoPoPoPyeOlyeyeyeQByeyeyeyeyeyeyeyeyeyeyeyeyeyeyeyeyeyeyeyeyeyeyeUqUqyeyeyeyeyeyeyeyeyeyeyeyeyeyeyeGx
GxgsgsgsgsgsgsSkBIBIBIBIBIBIBIBISkgsgsgsgsgsgsgsyeyeUqyeSkBIBIBISkBIBIBIBISkyeyeyeOlyeyeoPoPoPoPoPoPoPoPoPyeOlyeyeyeyeyeyeyeyeyeyeyeyeQByeyeyeyeyeyeyeyeyeyedBdBdBdBdBdBdBdBdBdByeyeyeyeyeyeyeyeyeyeyeGx
GxgsgsgsgsgsgsSkBIBIBISkSkSkSkSkSkgsgsgsgsgsgsgsyeyeUqyeSkBIBIBIBIBIBIBIBISkyeyeyeOlyeyeoPoPoPoPoPoPoPoPoPyeOlyeyeyeyeyeyeyeyeyeyeyeyeyeyeyeyeyeyeyeyeyeyeyedBdBdBdBdBdBdBdBdBdByeyeyeyeyeyeyeyeyeyeyeGx
GxgsgsgsgsgsSkSkkOkOkOSkgsgsgsgsgsgsgsgsgsgsgsgsyeyeUqyeSkBIBIBISkBIBIBIBISkyeyeyeOlyeyeoPoPoPidoPoPoPoPoPyeOlyeyeyeyeyeyeyeyeyeyeyeyeyeyeyeyeyeyeyeyeyeyeyedBdBdBdBdBdBdBdBdBdByeyeyeyeyeyeyeyeyeyeyeGx
GxgsgsgsgsgskOkOkOkOkOSkSkgsgsgsgsgsgsgsgsgsgsgsyeyeUqUqBIBIBIBISkSkSkSkSkSkyeyeyeOlyeyeoPoPoPoPoPoPoPoPoPyeOlyeyeyeyeyeyeyeyeyeyeyeyeyeyeyeyeyeyeyeyeyeyeyedBdBdBdBdBdBdBdBdBdByeyeyeyeyeyeyeyeyeyeyeGx
GxgsgsgsgskOkOkOkOkOkOkOkOkOgsgsgsgsgsgsgsgsgsgsyeyeyeyeSkBIBIBIBIBIBIBIBISkyeyeyeOlyeyeoPoPoPoPoPoPoPoPoPyeOlyeyeyeyeyeyeyeyeyeyeyeyeyeyeyeyeQByeyeyeyeyeyedBdBdBdBdBdBdBdBdBdByeyeyeyeyeyeyeyeyeyeyeGx
GxgsgsgsgsSkdBdBdBkOkOkOkOkOgsgsgsgsgsgsgsgsgsgsyeyeyeyeSkBIBIBIBIBIBIBIBISkyeyeyeOlyeyeoPoPoPoPoPoPoPoPoPyeOlyeyeyeyeyeyeyeyeyexXyeyeyeyeyeyeyeyeyeyeyeyeyedBdBdBdBdBdBdBdBdBdByeyeyeyeQByeyeyeyeyeyeGx
GxgsgsgskOdBdBdBdBkOkOkOkOkOgsgsgsgsgsgsgsgsgsgsyeyeyeyeSkSkSkSkSkSkSkSkSkSkyeyeyeOlyeyeoPoPoPoPoPoPoPoPoPyeOlyeyeyeyeyeyeyeyeyeyeyeyeyeyeyeyeyeyeyeyeyeyeyedBdBdBdBdBdBdBdBdBdByeyeyeyeyeyeyeyeyeyeyeGx
GxgsgskOkOdBdBdBdBkOkOkOkOgsgsgsgsgsgsgsgsgsgsgsyeyeyeyeyeyeyeyeyeyeyeyeyeyeyeyeyeOlyeyeoPoPoPoPoPoPoPoPoPyeOlyeyeyeyeyeyeyeyeyeyeyeyeyeyeyeyeyeyeyeyeyeyeyedBdBdBdBdBdBdBdBdBdByeyeyeyeyeyeyeyeyeyeyeGx
GxgsgskOkOSkdBdBdBSkkOkOkOkOgsgsgsgsgsgsgsgsgsgsyeyeyeyeyeyeyeyeyeyeyeyeyeyeyeyeyeOlyeyeoPoPoPoPoPoPoPoPoPyeOlyeyeyeyeyeyeyeyeyeyeyeyeyeyeyeyeyeyeyeyeyeyeyedBdBdBdBdBdBdBdBdBdByeyeyeyeyeyeyeyeyeyeyeGx
GxgsgskOkOdBdBdBdBdBkOkOkOkOqqSkSkgsgsgsgsgsgsgsyeyeyeyeyeyeyeyeyeyeQByeyeyeyeyeyeOlyeyeoPoPoPoPoPoPoPoPoPyeOlyeyeyeyeyeyeyeyeyeyeyeyeyeyeyeyeyeyeyeyeyeyeyedBdBdBdBdBdBdBdBdBdByeyeyeyeyeyeyeyeyeyeyeGx
GxgsgskOkOdBdBdBdBdBkOkOkOqqdBdBSkgsgsgsgsgsgsgsyeyeyeyeyeQByeyeyeyeyeyeyeyeyeyeyeOlyeyeoPoPoPoPoPoPoPoPoPyeOlyeyeyeyeyeyeyeyeyeyeyeyeyeyeyeyeyeyeyeyeyeyeyedBdBdBdBdBdBdBdBdBdByeyeyeyeyeyeyeyeyeyeyeGx
GxgsgskOkOdBdBdBdBdBkOkOqqdBdBdBSkgsgsgsgsgsgsgsyeyeyeyeyeyeyeyeyeyeyeyeyeyeyeyeyeOlyeyeoPoPoPoPoPoPoPoPoPyeOlyeyeyeyeyeQByeyeyeyeyeyeyeyeyeyeyeyeyeyeyeyeyedBdBdBdBdBdBdBdBdBdByeyeyeyeyeyeyeyeyeyeyeGx
GxgsgsgskOSkdBdBdBSkkOkOSkdBdBdBSkgsgsgsgsgsgsgsyeyeyeyeyeyeyeyeyeyeyeyeyeyeyeyeyeOlyeyeoPoPoPoPoPoPoPoPoPyeOlyeyeyeyeyeyeyeyeyeyeyeyeyeyeyeQByeyeyeyeyeyeyeyeyeyeyeyeyeyeyeyeyeyeyeyeyeyeyeyeQByeyeyeGx
GxgsgsgskOkOkOkOkOkOkOkOSkSkSkSkSkgsgsgsgsgsgsgsyeyeyeyeyeyeyeyeyeyeyeyeyeyeyeyeyeOlyeyeoPoPoPoPoPoPoPoPoPyeOlyeyeyeyeyeyeyeyeyeyeyeyeyeyeyeyeyeyeyeyeyeyeyeyeyeyeyeyeyeyeyeyeyeyeyeyeyeTeyeyeyeyeyeyeGx
GxgsgsgsgsgskOkOkOkOkOkOgsgsgsgsgsgsgsgsgsgsgsgsyeyeyeyeyeyeyeyeyeyeyeyeQByeyeyeyeOlyeyeoPoPoPoPoPoPoPoPoPyeOlyeyeyeyeyeyeyeTeyeyeyeyeyeyeyeyeyeyeyeyeyeyeyeyeyeyeyeyeyeyeyeyeyeyeyeyeyeyeyeyeyeyeyeyeGx
GxgsgsgsgsgsgsgsgsgsgsgsgsgsgsgsgsgsgsgsgsgsgsgsyeyeyeQByeyeyeyeyeyeyeyeyeyeyeyeyeOlyeyeoPoPoPoPoPoPoPoPoPyeOlyeyeyeyeyeyeyeyeyeyeyeyeyeyeyeyeyeyeyeyeyeyeyeyeyeyeyeyeyeyeyeyeyeyeyeyeyeyeyeyeyeyeyeyeGx
GxgsgsgsgsgsgsgsgsgsgsgsgsgsgsgsgsgsgsgsgsgsgsgsyeyeyeyeyeyeyeyeyeyeyeyeyeyeyeyeyeOlyeyeoPoPoPoPoPoPoPoPoPyeOlyeyeyeyeyeyeyeyeyeyeyeyeyeyeyeyeyeyeyeyeyeyeyeyeyeyeyeyeyeyeyeyeyeyeyeyeyeyeyeyeyeyeyeyeGx
GxGxGxGxGxGxGxGxGxGxGxGxGxGxGxGxGxGxGxGxGxGxGxGxGxGxGxGxGxGxGxGxGxGxGxGxGxGxGxGxGxGxGxGxoPoPoPoPoPoPoPoPoPGxGxGxGxGxGxGxGxGxGxGxGxGxGxGxGxGxGxGxGxGxGxGxGxGxGxGxGxGxGxGxGxGxGxGxGxGxGxGxGxGxGxGxGxGxGxGx
"}
