//MAP CONVERTED BY dmm2tgm.py THIS HEADER COMMENT PREVENTS RECONVERSION, DO NOT REMOVE
"ag" = (
/obj/effect/floor_decal/industrial/warning{
	dir = 10
	},
/obj/machinery/light/small,
/turf/simulated/floor/tiled/techfloor/grid,
/area/submap/DemonPool)
"aj" = (
/obj/effect/decal/cleanable/blood,
/obj/random/maintenance/research,
/turf/simulated/floor/cult,
/area/submap/DemonPool)
"au" = (
/obj/item/spellbook/oneuse/forcewall,
/obj/item/bone,
/obj/item/bone/ribs,
/obj/item/organ/internal/eyes,
/obj/structure/closet/crate/secure/decalock,
/turf/simulated/floor/cult,
/area/submap/DemonPool)
"ay" = (
/obj/structure/girder,
/obj/effect/floor_decal/rust,
/turf/simulated/floor/plating,
/area/submap/DemonPool)
"bb" = (
/mob/living/simple_mob/creature/cult/strong{
	icon_scale_x = 1.2;
	icon_scale_y = 1.2
	},
/obj/item/material/shard,
/turf/simulated/floor/cult,
/area/submap/DemonPool)
"bc" = (
/obj/machinery/door/airlock,
/turf/simulated/floor/tiled/steel_grid,
/area/submap/DemonPool)
"bh" = (
/obj/item/melee/energy/sword/red,
/obj/machinery/light/small/emergency{
	dir = 4
	},
/obj/structure/loot_pile/surface/bones,
/obj/random/maintenance/research,
/turf/simulated/floor/cult,
/area/submap/DemonPool)
"bo" = (
/obj/effect/decal/cleanable/ash,
/turf/simulated/floor/cult,
/area/submap/DemonPool)
"bw" = (
/obj/machinery/light/small{
	dir = 1
	},
/turf/simulated/floor/plating,
/area/submap/DemonPool)
"bz" = (
/obj/effect/decal/cleanable/dirt,
/obj/random/vendordrink,
/turf/simulated/floor/tiled/steel_grid,
/area/submap/DemonPool)
"bO" = (
/obj/item/material/shard,
/turf/simulated/floor/tiled/steel_grid,
/area/submap/DemonPool)
"cn" = (
/obj/effect/floor_decal/corner/purple/border{
	dir = 1
	},
/turf/simulated/floor/tiled/steel_grid,
/area/submap/DemonPool)
"de" = (
/turf/simulated/wall/concrete,
/area/submap/DemonPool)
"dG" = (
/obj/structure/closet/secure_closet/personal,
/obj/item/clothing/suit/storage/hooded/wintercoat,
/turf/simulated/floor/tiled/steel_grid,
/area/submap/DemonPool)
"ee" = (
/obj/random/obstruction,
/obj/effect/decal/cleanable/dirt,
/turf/simulated/floor/plating,
/area/submap/DemonPool)
"es" = (
/obj/fire,
/obj/fire,
/obj/effect/floor_decal/industrial/warning/corner,
/turf/simulated/floor/cult,
/area/submap/DemonPool)
"eM" = (
/obj/effect/floor_decal/industrial/warning/dust{
	dir = 8
	},
/obj/effect/floor_decal/rust,
/turf/simulated/floor/tiled/asteroid_steel,
/area/submap/DemonPool)
"eR" = (
/turf/simulated/wall/cult,
/area/submap/DemonPool)
"eV" = (
/turf/simulated/mineral/ignore_mapgen,
/area/template_noop)
"eW" = (
/turf/template_noop,
/area/template_noop)
"fW" = (
/obj/effect/floor_decal/industrial/warning{
	dir = 6
	},
/obj/machinery/light/small,
/turf/simulated/floor/tiled/techfloor/grid,
/area/submap/DemonPool)
"gt" = (
/obj/random/junk,
/obj/effect/decal/cleanable/dirt,
/turf/simulated/floor/plating,
/area/submap/DemonPool)
"gF" = (
/turf/simulated/floor/outdoors/dirt{
	outdoors = 0
	},
/area/template_noop)
"hr" = (
/obj/effect/floor_decal/industrial/warning{
	dir = 6
	},
/turf/simulated/floor/tiled/techfloor/grid,
/area/submap/DemonPool)
"hF" = (
/mob/living/simple_mob/creature/cult/strong,
/obj/item/material/shard,
/obj/item/material/shard,
/obj/effect/floor_decal/industrial/warning/corner{
	dir = 1
	},
/turf/simulated/floor/cult,
/area/submap/DemonPool)
"hO" = (
/obj/structure/grille/cult,
/obj/structure/window/reinforced/full,
/turf/simulated/floor/cult,
/area/submap/DemonPool)
"hP" = (
/obj/fire,
/obj/fire,
/obj/fire,
/obj/structure/grille/cult,
/obj/structure/window/reinforced/full,
/turf/simulated/floor/cult,
/area/submap/DemonPool)
"hQ" = (
/obj/structure/salvageable/machine_os,
/turf/simulated/floor/tiled/steel_grid,
/area/submap/DemonPool)
"hV" = (
/obj/structure/table/steel,
/obj/item/taperecorder,
/turf/simulated/floor/tiled/steel_grid,
/area/submap/DemonPool)
"hW" = (
/obj/effect/decal/cleanable/dirt,
/obj/item/clothing/accessory/stethoscope,
/obj/item/storage/belt/medical,
/obj/random/maintenance/medical,
/obj/random/medical,
/obj/random/firstaid,
/obj/random/medical,
/obj/structure/closet/crate/secure/decalock{
	name = "decalock Nanomed crate";
	closet_appearance = /decl/closet_appearance/crate/secure/nanotrasenmedical;
	desc = "A secure crate emblazoned with the NanoMed Medical livery, a subsidary of the NanoTrasen Corporation."
	},
/turf/simulated/floor/plating,
/area/submap/DemonPool)
"hZ" = (
/obj/effect/floor_decal/industrial/warning/dust{
	dir = 9
	},
/turf/simulated/floor/tiled/asteroid_steel,
/area/submap/DemonPool)
"iq" = (
/obj/effect/decal/cleanable/blood/drip,
/turf/simulated/floor/carpet,
/area/submap/DemonPool)
"it" = (
/obj/machinery/power/apc{
	dir = 1;
	name = "north bump";
	pixel_y = 24;
	operating = 0
	},
/turf/simulated/floor/plating,
/area/submap/DemonPool)
"jt" = (
/obj/structure/cult/pylon,
/obj/machinery/artifact_scanpad,
/obj/fire,
/obj/fire,
/obj/machinery/light/small/emergency,
/turf/simulated/floor/cult,
/area/submap/DemonPool)
"jv" = (
/turf/simulated/floor/outdoors/dirt,
/area/template_noop)
"jG" = (
/obj/effect/floor_decal/corner/purple/border{
	dir = 8
	},
/obj/item/material/shard,
/turf/simulated/floor/tiled/steel_grid,
/area/submap/DemonPool)
"jK" = (
/obj/fire,
/obj/fire,
/turf/simulated/floor/cult,
/area/submap/DemonPool)
"jS" = (
/obj/effect/floor_decal/industrial/warning/full,
/obj/structure/window/reinforced,
/obj/structure/window/reinforced{
	dir = 8
	},
/obj/structure/window/reinforced{
	dir = 1
	},
/obj/structure/cult/pylon,
/obj/machinery/door/window/eastleft,
/turf/simulated/floor/cult,
/area/submap/DemonPool)
"jX" = (
/obj/structure/loot_pile/maint/trash,
/turf/simulated/floor/outdoors/dirt{
	outdoors = 0
	},
/area/submap/DemonPool)
"kc" = (
/obj/effect/floor_decal/industrial/warning/corner{
	dir = 1
	},
/turf/simulated/floor/cult,
/area/submap/DemonPool)
"lo" = (
/obj/effect/floor_decal/industrial/warning/full,
/obj/structure/window/reinforced{
	dir = 1
	},
/obj/structure/cult/pylon,
/obj/structure/window/reinforced{
	dir = 8
	},
/obj/structure/window/reinforced{
	dir = 4
	},
/obj/machinery/door/window/southleft,
/turf/simulated/floor/cult,
/area/submap/DemonPool)
"lr" = (
/turf/simulated/floor/carpet,
/area/submap/DemonPool)
"lG" = (
/turf/simulated/floor/tiled/steel_grid,
/area/submap/DemonPool)
"lV" = (
/obj/random/obstruction,
/turf/simulated/floor/plating,
/area/submap/DemonPool)
"md" = (
/obj/machinery/space_heater,
/obj/effect/floor_decal/industrial/hatch/yellow,
/turf/simulated/floor/plating,
/area/submap/DemonPool)
"mp" = (
/obj/random/trash,
/turf/simulated/floor/outdoors/dirt{
	outdoors = 0
	},
/area/submap/DemonPool)
"mO" = (
/obj/effect/floor_decal/industrial/warning{
	dir = 4
	},
/turf/simulated/floor/cult,
/area/submap/DemonPool)
"mQ" = (
/obj/effect/gateway,
/turf/simulated/floor/tiled/steel_grid,
/area/submap/DemonPool)
"mU" = (
/obj/fire,
/obj/fire,
/obj/effect/floor_decal/industrial/warning{
	dir = 8
	},
/turf/simulated/floor/cult,
/area/submap/DemonPool)
"mX" = (
/obj/structure/bed/chair/office/dark{
	dir = 4
	},
/turf/simulated/floor/tiled/steel_grid,
/area/submap/DemonPool)
"nH" = (
/obj/machinery/door/window/westright,
/obj/structure/salvageable/data,
/obj/structure/window/reinforced{
	dir = 4
	},
/obj/structure/window/reinforced,
/obj/effect/floor_decal/industrial/warning{
	dir = 8
	},
/turf/simulated/floor/cult,
/area/submap/DemonPool)
"oi" = (
/obj/structure/table/standard,
/obj/item/flashlight/lamp,
/obj/random/medical/lite,
/obj/item/paper{
	name = "caretaker log";
	info = "<I>An excerpt from a much longer and more mundane journal. There's spots for times and dates, but oddly every single one seems to have been smudged or damaged...</I> <BR> Whole team of eggheads keep coming and going to check out the new site. Going to need more medical supplies, they leaving the lab with what look like radiation burns all over their bodies and weird looks in their eyes. One's even in the bathroom now, 'cleaning up'. <BR> Maybe that old surplus crate has some useful stuff, just need to figure out how to pop the lock."
	},
/turf/simulated/floor/carpet,
/area/submap/DemonPool)
"on" = (
/obj/effect/decal/cleanable/blood,
/turf/simulated/floor/tiled/steel_grid,
/area/submap/DemonPool)
"oN" = (
/obj/fire,
/obj/structure/grille/cult,
/obj/structure/window/reinforced/full,
/turf/simulated/floor/cult,
/area/submap/DemonPool)
"pb" = (
/obj/structure/table/standard,
/obj/item/pen/fountain,
/obj/item/paper_bin,
/turf/simulated/floor/tiled/steel_grid,
/area/submap/DemonPool)
"pE" = (
/obj/fire,
/obj/fire,
/turf/simulated/floor/tiled/steel_grid,
/area/submap/DemonPool)
"pH" = (
/obj/effect/floor_decal/rust,
/obj/fire,
/turf/simulated/floor/tiled/steel_grid,
/area/submap/DemonPool)
"pX" = (
/obj/machinery/door/airlock,
/obj/effect/decal/cleanable/blood/drip,
/turf/simulated/floor/cult,
/area/submap/DemonPool)
"qa" = (
/obj/machinery/portable_atmospherics/powered/scrubber,
/obj/effect/floor_decal/industrial/hatch/yellow,
/turf/simulated/floor/plating,
/area/submap/DemonPool)
"qb" = (
/obj/structure/grille/cult,
/obj/machinery/door/blast/regular/open,
/obj/structure/window/reinforced/full,
/turf/simulated/floor/cult,
/area/submap/DemonPool)
"qc" = (
/obj/machinery/light/small{
	dir = 8
	},
/turf/simulated/floor/tiled/steel_grid,
/area/submap/DemonPool)
"qQ" = (
/obj/fire,
/turf/simulated/floor/cult,
/area/submap/DemonPool)
"rh" = (
/obj/effect/floor_decal/industrial/warning{
	dir = 5
	},
/turf/simulated/floor/tiled/techfloor/grid,
/area/submap/DemonPool)
"sb" = (
/obj/effect/floor_decal/industrial/warning/full,
/obj/structure/window/reinforced,
/obj/structure/window/reinforced{
	dir = 1
	},
/obj/structure/window/reinforced{
	dir = 4;
	health = 1e+006
	},
/obj/structure/cult/pylon,
/obj/machinery/door/window/westleft,
/turf/simulated/floor/cult,
/area/submap/DemonPool)
"si" = (
/obj/fire,
/obj/fire,
/obj/effect/floor_decal/industrial/warning{
	dir = 1
	},
/turf/simulated/floor/cult,
/area/submap/DemonPool)
"sC" = (
/obj/effect/decal/remains/mummy2,
/obj/item/clothing/suit/storage/hooded/wintercoat/janitor,
/obj/item/bedsheet/brown,
/obj/item/stack/material/silver{
	amount = 15
	},
/turf/simulated/floor/plating,
/area/submap/DemonPool)
"sM" = (
/obj/effect/decal/cleanable/ash,
/obj/fire,
/obj/fire,
/turf/simulated/floor/cult,
/area/submap/DemonPool)
"sZ" = (
/obj/random/junk,
/obj/random/junk,
/turf/simulated/floor/plating,
/area/submap/DemonPool)
"tq" = (
/obj/effect/floor_decal/industrial/hatch/yellow,
/obj/structure/sign/warning{
	name = "\improper PROTECTIVE EQUIPMENT MUST BE WORN";
	pixel_x = 32
	},
/obj/machinery/door/airlock/highsecurity,
/turf/simulated/floor/tiled/steel_grid,
/area/submap/DemonPool)
"tC" = (
/obj/effect/floor_decal/corner/purple/border{
	dir = 5
	},
/obj/effect/floor_decal/rust,
/obj/structure/table/rack,
/obj/item/clothing/gloves/sterile/latex,
/obj/item/clothing/glasses/science,
/turf/simulated/floor/tiled/steel_grid,
/area/submap/DemonPool)
"vk" = (
/obj/effect/floor_decal/industrial/warning/corner{
	dir = 8
	},
/obj/effect/spawner/gibs/human,
/turf/simulated/floor/cult,
/area/submap/DemonPool)
"vv" = (
/obj/fire,
/obj/machinery/door/airlock/glass_research,
/turf/simulated/floor/cult,
/area/submap/DemonPool)
"vw" = (
/obj/structure/bed/chair/office/dark{
	dir = 8
	},
/obj/fire,
/turf/simulated/floor/tiled/steel_grid,
/area/submap/DemonPool)
"vA" = (
/obj/fire,
/obj/fire,
/mob/living/simple_mob/faithless/cult,
/obj/effect/floor_decal/industrial/warning{
	dir = 8
	},
/turf/simulated/floor/cult,
/area/submap/DemonPool)
"vJ" = (
/turf/simulated/floor/outdoors/dirt,
/area/submap/DemonPool)
"vW" = (
/obj/effect/floor_decal/rust,
/obj/structure/table/steel,
/turf/simulated/floor/tiled/steel_grid,
/area/submap/DemonPool)
"xl" = (
/obj/structure/table/standard,
/obj/item/book,
/obj/item/flashlight/lamp/green,
/turf/simulated/floor/tiled/steel_grid,
/area/submap/DemonPool)
"yv" = (
/obj/structure/extinguisher_cabinet{
	dir = 8;
	pixel_x = -30
	},
/turf/simulated/floor/tiled/steel_grid,
/area/submap/DemonPool)
"yS" = (
/obj/structure/closet/crate,
/obj/item/stack/material/phoron{
	amount = 25
	},
/obj/effect/floor_decal/industrial/hatch/yellow,
/turf/simulated/floor/plating,
/area/submap/DemonPool)
"yW" = (
/obj/item/clothing/suit/storage/toggle/labcoat,
/obj/effect/decal/remains/human,
/obj/item/clothing/head/culthood{
	start_anomalous = 1
	},
/obj/effect/spawner/gibs/human,
/turf/simulated/floor/cult,
/area/submap/DemonPool)
"zi" = (
/obj/effect/decal/cleanable/blood/drip,
/turf/simulated/floor/tiled/steel_grid,
/area/submap/DemonPool)
"zj" = (
/obj/effect/floor_decal/industrial/warning{
	dir = 1
	},
/turf/simulated/floor/cult,
/area/submap/DemonPool)
"zs" = (
/obj/structure/table/rack,
/obj/random/maintenance/research,
/obj/random/junk,
/turf/simulated/floor/plating,
/area/submap/DemonPool)
"zI" = (
/obj/effect/floor_decal/corner/purple/border{
	dir = 4
	},
/turf/simulated/floor/tiled/steel_grid,
/area/submap/DemonPool)
"zS" = (
/obj/fire,
/mob/living/simple_mob/creature/cult,
/turf/simulated/floor/cult,
/area/submap/DemonPool)
"zU" = (
/obj/structure/sign/warning/cold{
	layer = 3.3;
	pixel_y = -32
	},
/turf/simulated/wall/r_concrete,
/area/submap/DemonPool)
"zZ" = (
/obj/structure/grille,
/obj/structure/window/reinforced/full,
/turf/simulated/floor/plating,
/area/submap/DemonPool)
"Ag" = (
/obj/fire,
/obj/fire,
/obj/effect/spawner/gibs/human,
/mob/living/simple_mob/faithless/cult/strong{
	health = 250;
	melee_damage_lower = 20;
	melee_damage_upper = 30;
	name = "Recursive entity";
	icon_scale_x = 1.3;
	icon_scale_y = 1.3
	},
/obj/effect/floor_decal/industrial/warning{
	dir = 1
	},
/turf/simulated/floor/cult,
/area/submap/DemonPool)
"Ah" = (
/obj/machinery/door/window/westright,
/obj/structure/window/reinforced{
	dir = 4
	},
/obj/effect/floor_decal/industrial/warning{
	dir = 8
	},
/obj/item/book/tome,
/obj/item/spellbook/oneuse/fireball,
/obj/item/bone/skull/unknown,
/obj/structure/closet/crate/secure/decalock{
	desc = "A hefty, reinforced metal crate with an electronic locking system.";
	name = "reinforced decalock crate";
	closet_appearance = /decl/closet_appearance/large_crate/secure;
	health = 300
	},
/turf/simulated/floor/cult,
/area/submap/DemonPool)
"Ax" = (
/obj/machinery/door/airlock/maintenance/common,
/turf/simulated/floor/plating,
/area/submap/DemonPool)
"AB" = (
/obj/structure/girder/reinforced,
/obj/effect/floor_decal/rust,
/turf/simulated/floor/plating,
/area/submap/DemonPool)
"AF" = (
/obj/machinery/door/airlock/external,
/obj/effect/floor_decal/industrial/hatch/yellow,
/turf/simulated/floor/tiled/techfloor/grid,
/area/submap/DemonPool)
"AH" = (
/obj/structure/cult/tome,
/turf/simulated/floor/cult,
/area/submap/DemonPool)
"Bb" = (
/obj/effect/decal/cleanable/blood/oil,
/turf/simulated/floor/plating,
/area/submap/DemonPool)
"Br" = (
/obj/effect/floor_decal/industrial/warning{
	dir = 8
	},
/obj/fire,
/turf/simulated/floor/cult,
/area/submap/DemonPool)
"BO" = (
/obj/effect/floor_decal/industrial/warning{
	dir = 9
	},
/turf/simulated/floor/tiled/techfloor/grid,
/area/submap/DemonPool)
"CS" = (
/obj/item/material/shard,
/obj/effect/floor_decal/rust,
/obj/effect/decal/cleanable/blood/drip,
/turf/simulated/floor/tiled/steel_grid,
/area/submap/DemonPool)
"CV" = (
/obj/structure/flora/tree/sif,
/turf/template_noop,
/area/submap/DemonPool)
"CY" = (
/obj/fire,
/obj/structure/grille,
/obj/item/material/shard,
/turf/simulated/floor/cult,
/area/submap/DemonPool)
"Dj" = (
/obj/structure/simple_door/cult,
/turf/simulated/floor/cult,
/area/submap/DemonPool)
"DE" = (
/obj/fire,
/turf/simulated/floor/tiled/steel_grid,
/area/submap/DemonPool)
"DY" = (
/obj/random/mob/sif/hostile,
/obj/structure/animal_den,
/turf/simulated/floor/outdoors/dirt{
	outdoors = 0
	},
/area/submap/DemonPool)
"DZ" = (
/obj/effect/decal/cleanable/dirt,
/turf/simulated/floor/plating,
/area/submap/DemonPool)
"EQ" = (
/obj/structure/bed/padded,
/obj/item/bedsheet/brown,
/turf/simulated/floor/carpet,
/area/submap/DemonPool)
"Fe" = (
/obj/structure/grille/cult,
/obj/item/material/shard,
/turf/simulated/floor/cult,
/area/submap/DemonPool)
"Fq" = (
/obj/effect/floor_decal/corner/purple/border{
	dir = 1
	},
/obj/structure/table/rack,
/turf/simulated/floor/tiled/steel_grid,
/area/submap/DemonPool)
"Fu" = (
/obj/structure/mirror{
	icon_state = "mirror_broke"
	},
/turf/simulated/wall/concrete,
/area/submap/DemonPool)
"Hb" = (
/turf/template_noop,
/area/submap/DemonPool)
"Hg" = (
/obj/structure/grille,
/obj/structure/window/reinforced/full,
/turf/simulated/floor/cult,
/area/submap/DemonPool)
"Hh" = (
/obj/effect/floor_decal/corner/purple/border,
/obj/machinery/light/small,
/turf/simulated/floor/tiled/steel_grid,
/area/submap/DemonPool)
"Hl" = (
/obj/effect/floor_decal/corner/purple/border,
/turf/simulated/floor/tiled/steel_grid,
/area/submap/DemonPool)
"Hq" = (
/obj/fire,
/obj/effect/floor_decal/industrial/warning/corner{
	dir = 4
	},
/turf/simulated/floor/cult,
/area/submap/DemonPool)
"Iu" = (
/obj/structure/sink{
	dir = 4;
	pixel_x = 11
	},
/turf/simulated/floor/cult,
/area/submap/DemonPool)
"IP" = (
/obj/item/material/shard,
/obj/fire,
/turf/simulated/floor/cult,
/area/submap/DemonPool)
"Jo" = (
/turf/simulated/mineral/ignore_mapgen,
/area/submap/DemonPool)
"JB" = (
/mob/living/simple_mob/creature/cult,
/turf/simulated/floor/cult,
/area/submap/DemonPool)
"JK" = (
/obj/item/material/shard,
/turf/simulated/floor/cult,
/area/submap/DemonPool)
"JM" = (
/obj/effect/floor_decal/corner/purple/border,
/obj/fire,
/turf/simulated/floor/tiled/steel_grid,
/area/submap/DemonPool)
"JN" = (
/obj/effect/floor_decal/industrial/warning{
	dir = 8
	},
/turf/simulated/floor/cult,
/area/submap/DemonPool)
"JP" = (
/obj/effect/floor_decal/industrial/warning/dust{
	dir = 10
	},
/turf/simulated/floor/tiled/asteroid_steel,
/area/submap/DemonPool)
"JV" = (
/obj/structure/bookcase{
	name = "bookcase (Religious)"
	},
/turf/simulated/floor/tiled/steel_grid,
/area/submap/DemonPool)
"JX" = (
/obj/effect/floor_decal/corner/purple/border{
	dir = 8
	},
/obj/effect/floor_decal/rust,
/obj/structure/salvageable/console_broken_os{
	dir = 4
	},
/turf/simulated/floor/tiled/steel_grid,
/area/submap/DemonPool)
"JZ" = (
/obj/structure/table/steel,
/obj/machinery/light/small/emergency{
	dir = 8
	},
/obj/fire,
/turf/simulated/floor/cult,
/area/submap/DemonPool)
"Ko" = (
/obj/machinery/light/small/emergency{
	dir = 4
	},
/turf/simulated/floor/plating,
/area/submap/DemonPool)
"KM" = (
/obj/structure/sign/warning/high_voltage,
/turf/simulated/wall/concrete,
/area/submap/DemonPool)
"KR" = (
/obj/effect/spawner/gibs/human,
/turf/simulated/floor/cult,
/area/submap/DemonPool)
"Lh" = (
/obj/effect/floor_decal/industrial/hatch/yellow,
/obj/structure/simple_door/cult,
/turf/simulated/floor/cult,
/area/submap/DemonPool)
"Ll" = (
/obj/machinery/door/window/westright,
/obj/structure/salvageable/data,
/obj/structure/window/reinforced{
	dir = 4
	},
/obj/structure/window/reinforced{
	dir = 1
	},
/obj/effect/floor_decal/industrial/warning{
	dir = 8
	},
/turf/simulated/floor/cult,
/area/submap/DemonPool)
"Lu" = (
/obj/machinery/door/airlock/external,
/obj/effect/floor_decal/industrial/hatch/yellow,
/obj/effect/decal/cleanable/dirt,
/turf/simulated/floor/tiled/techfloor/grid,
/area/submap/DemonPool)
"Lx" = (
/obj/structure/table/standard,
/obj/structure/flora/pottedplant/overgrown{
	pixel_y = 12
	},
/turf/simulated/floor/tiled/steel_grid,
/area/submap/DemonPool)
"LD" = (
/obj/effect/floor_decal/rust,
/turf/simulated/floor/tiled/steel_grid,
/area/submap/DemonPool)
"MB" = (
/obj/machinery/door/airlock/science,
/turf/simulated/floor/tiled/steel_grid,
/area/submap/DemonPool)
"NI" = (
/obj/effect/decal/cleanable/blood,
/obj/structure/toilet,
/mob/living/simple_mob/faithless/cult/strong,
/turf/simulated/floor/cult,
/area/submap/DemonPool)
"Oo" = (
/obj/effect/floor_decal/industrial/warning/dust{
	dir = 8
	},
/turf/simulated/floor/tiled/asteroid_steel,
/area/submap/DemonPool)
"OK" = (
/obj/structure/closet/crate/trashcart,
/obj/random/contraband,
/obj/random/junk,
/obj/random/junk,
/obj/random/junk,
/obj/random/junk,
/obj/random/junk,
/turf/simulated/floor/outdoors/dirt{
	outdoors = 0
	},
/area/submap/DemonPool)
"OZ" = (
/obj/effect/decal/cleanable/dirt,
/obj/structure/table/rack,
/obj/random/maintenance,
/turf/simulated/floor/plating,
/area/submap/DemonPool)
"Pu" = (
/turf/simulated/floor/plating,
/area/submap/DemonPool)
"PC" = (
/obj/structure/bed/chair/sofa/black/right{
	dir = 1
	},
/turf/simulated/floor/tiled/steel_grid,
/area/submap/DemonPool)
"PG" = (
/obj/machinery/floodlight,
/turf/simulated/floor/tiled/steel_grid,
/area/submap/DemonPool)
"Qq" = (
/obj/structure/salvageable/data,
/obj/structure/window/reinforced{
	dir = 8
	},
/obj/effect/floor_decal/corner/purple/border{
	dir = 4
	},
/obj/effect/floor_decal/industrial/warning/full,
/obj/machinery/door/window/southleft,
/obj/machinery/door/window/northleft,
/obj/machinery/light/small/emergency{
	dir = 4
	},
/turf/simulated/floor/tiled/steel_grid,
/area/submap/DemonPool)
"Qr" = (
/obj/effect/floor_decal/industrial/warning{
	dir = 5
	},
/obj/effect/decal/cleanable/blood/drip,
/turf/simulated/floor/tiled/techfloor/grid,
/area/submap/DemonPool)
"Qv" = (
/obj/structure/table/steel,
/turf/simulated/floor/cult,
/area/submap/DemonPool)
"Qz" = (
/turf/simulated/floor/cult,
/area/submap/DemonPool)
"Ro" = (
/obj/structure/table/rack,
/obj/item/clothing/gloves/sterile/latex,
/obj/item/clothing/glasses/science,
/obj/effect/floor_decal/corner/purple/border{
	dir = 1
	},
/obj/effect/floor_decal/rust,
/turf/simulated/floor/tiled/steel_grid,
/area/submap/DemonPool)
"RL" = (
/obj/effect/floor_decal/industrial/warning{
	dir = 10
	},
/turf/simulated/floor/tiled/techfloor/grid,
/area/submap/DemonPool)
"RP" = (
/obj/effect/floor_decal/corner/purple/border{
	dir = 4
	},
/obj/effect/floor_decal/rust,
/obj/fire,
/turf/simulated/floor/tiled/steel_grid,
/area/submap/DemonPool)
"Sx" = (
/obj/effect/decal/cleanable/dirt,
/obj/machinery/light/small{
	dir = 1
	},
/obj/random/vendorfood,
/turf/simulated/floor/tiled/steel_grid,
/area/submap/DemonPool)
"Tg" = (
/obj/structure/closet/emcloset,
/turf/simulated/floor/tiled/steel_grid,
/area/submap/DemonPool)
"Tt" = (
/obj/structure/loot_pile/maint/technical,
/turf/simulated/floor/plating,
/area/submap/DemonPool)
"Vf" = (
/obj/structure/loot_pile/surface/bones,
/obj/random/maintenance/security,
/obj/random/projectile/scrapped_laser,
/turf/simulated/floor/cult,
/area/submap/DemonPool)
"Vk" = (
/obj/machinery/door/blast/regular/open,
/obj/structure/grille/cult,
/obj/item/material/shard,
/turf/simulated/floor/cult,
/area/submap/DemonPool)
"VK" = (
/turf/simulated/wall/r_concrete,
/area/submap/DemonPool)
"WV" = (
/obj/effect/floor_decal/corner/purple/border,
/obj/item/material/shard,
/turf/simulated/floor/tiled/steel_grid,
/area/submap/DemonPool)
"Xe" = (
/obj/structure/salvageable/computer_os,
/turf/simulated/floor/cult,
/area/submap/DemonPool)
"XB" = (
/obj/effect/decal/cleanable/ash,
/obj/effect/spawner/gibs/human,
/obj/item/material/shard,
/mob/living/simple_mob/faithless/cult,
/obj/effect/floor_decal/industrial/warning{
	dir = 4
	},
/turf/simulated/floor/cult,
/area/submap/DemonPool)
"XJ" = (
/obj/machinery/power/port_gen/pacman,
/obj/effect/floor_decal/industrial/hatch/yellow,
/turf/simulated/floor/plating,
/area/submap/DemonPool)
"XP" = (
/obj/effect/floor_decal/industrial/warning{
	dir = 4
	},
/obj/effect/decal/cleanable/ash,
/turf/simulated/floor/cult,
/area/submap/DemonPool)
"Yk" = (
/obj/structure/bed/chair/office/dark{
	dir = 1
	},
/obj/effect/decal/cleanable/ash,
/turf/simulated/floor/cult,
/area/submap/DemonPool)
"Yy" = (
/obj/structure/loot_pile/surface/bones,
/obj/item/melee/cursedblade{
	start_anomalous = 1
	},
/obj/item/clothing/suit/cultrobes,
/mob/living/simple_mob/creature/cult,
/obj/effect/floor_decal/industrial/warning/corner{
	dir = 4
	},
/turf/simulated/floor/cult,
/area/submap/DemonPool)
"YF" = (
/turf/simulated/floor/outdoors/dirt{
	outdoors = 0
	},
/area/submap/DemonPool)
"YK" = (
/obj/effect/decal/cleanable/dirt,
/turf/simulated/floor/tiled/steel_grid,
/area/submap/DemonPool)
"Zc" = (
/obj/effect/floor_decal/industrial/warning{
	dir = 9
	},
/obj/effect/decal/cleanable/dirt,
/turf/simulated/floor/tiled/techfloor/grid,
/area/submap/DemonPool)
"Zj" = (
/obj/effect/decal/cleanable/dirt,
/obj/structure/bed/chair/sofa/black/left{
	dir = 1
	},
/turf/simulated/floor/tiled/steel_grid,
/area/submap/DemonPool)
"ZU" = (
/obj/machinery/light/small{
	dir = 1
	},
/mob/living/simple_mob/faithless/cult,
/obj/effect/floor_decal/industrial/warning,
/turf/simulated/floor/cult,
/area/submap/DemonPool)

(1,1,1) = {"
eW
eW
eW
eW
eV
eV
eW
eW
eW
eW
eW
jv
jv
eW
eW
eV
eV
eV
eV
eV
eV
eW
eW
eW
eW
"}
(2,1,1) = {"
eW
Hb
Hb
Jo
Jo
Jo
Jo
Hb
vJ
hZ
eM
Oo
JP
vJ
Jo
Jo
Jo
Jo
Jo
Jo
Jo
Jo
Hb
Hb
eW
"}
(3,1,1) = {"
eW
Hb
Jo
Jo
Jo
Jo
Jo
Jo
Jo
zU
zZ
AF
VK
Jo
VK
VK
eR
eR
eR
eR
eR
eR
Jo
Hb
eW
"}
(4,1,1) = {"
eW
Hb
Jo
Jo
jX
DY
Jo
Jo
Jo
VK
Zc
RL
VK
VK
eR
JX
JZ
Qz
CY
IP
zS
eR
Jo
Jo
eW
"}
(5,1,1) = {"
eW
Jo
Jo
YF
mp
YF
OK
Jo
VK
VK
rh
fW
VK
VK
Xe
vw
vW
qQ
vv
JB
jt
eR
Jo
Jo
eV
"}
(6,1,1) = {"
eW
YF
mp
YF
YF
YF
VK
VK
VK
VK
zZ
Lu
VK
VK
Ro
lG
Qz
pH
Hg
qQ
bb
eR
Jo
Jo
eV
"}
(7,1,1) = {"
eW
Jo
Jo
jX
YF
YF
VK
EQ
lr
de
Tg
YK
Lx
de
Fq
lG
pE
CS
eR
eR
eR
eR
VK
Jo
eV
"}
(8,1,1) = {"
eW
Jo
Jo
Jo
jX
mp
VK
oi
iq
bc
lG
zi
YK
MB
cn
lG
Qv
lG
LD
tq
BO
ag
VK
Jo
eW
"}
(9,1,1) = {"
eW
Jo
Jo
Jo
VK
Ax
VK
de
pX
de
Sx
lG
lG
de
tC
zI
Qq
RP
au
VK
Qr
hr
VK
Jo
eW
"}
(10,1,1) = {"
eW
Jo
Jo
VK
VK
DZ
VK
NI
yW
de
bz
lG
PG
VK
eR
VK
eR
eR
eR
eR
Lh
eR
VK
Hb
eW
"}
(11,1,1) = {"
eW
Hb
Jo
VK
OZ
DZ
VK
AH
Iu
de
YK
lG
Zj
VK
eR
eR
KR
Vf
Qz
sM
jG
Qz
eR
Jo
eW
"}
(12,1,1) = {"
eW
Hb
Jo
VK
hW
DZ
VK
de
Fu
de
lG
lG
PC
VK
eR
jK
JK
sb
Xe
Qz
bo
JM
eR
Jo
eV
"}
(13,1,1) = {"
eW
Hb
Jo
VK
VK
DZ
VK
dG
qc
yv
lG
YK
JV
VK
mO
XP
mO
mO
Hq
on
zi
Hl
eR
Jo
eV
"}
(14,1,1) = {"
eW
Hb
Jo
Jo
VK
gt
VK
dG
YK
lG
lG
lG
mX
VK
Vk
qb
hP
eR
zj
Qz
hV
WV
eR
Jo
eV
"}
(15,1,1) = {"
eW
Hb
Hb
Jo
VK
Pu
VK
de
Ax
KM
de
pb
xl
VK
es
XB
Yy
oN
si
Qz
hQ
Yk
eR
Jo
eV
"}
(16,1,1) = {"
eW
Hb
Jo
Jo
VK
Pu
VK
md
DZ
qa
de
de
de
VK
ZU
mQ
Ag
Dj
zj
qQ
lo
Hl
eR
Jo
eV
"}
(17,1,1) = {"
eW
Hb
Jo
Jo
VK
bw
Ax
Pu
Pu
yS
de
Tt
Pu
VK
vk
vA
hF
hO
zj
Qz
hQ
Yk
eR
Jo
eV
"}
(18,1,1) = {"
eW
Jo
Jo
Jo
VK
DZ
VK
it
Ko
XJ
de
sZ
sC
VK
hO
hO
Fe
eR
si
KR
Qv
Hl
eR
Jo
eV
"}
(19,1,1) = {"
eW
Jo
Jo
YF
AB
Pu
VK
VK
VK
VK
VK
VK
VK
VK
mU
Br
JN
JN
kc
bO
DE
Hh
VK
Jo
eV
"}
(20,1,1) = {"
eW
Hb
YF
YF
VK
Pu
Pu
Bb
Pu
DZ
DZ
DZ
lV
VK
eR
Qz
aj
jS
Xe
qQ
bo
Hl
eR
Jo
eV
"}
(21,1,1) = {"
eW
YF
Jo
Jo
VK
VK
VK
ee
zs
DZ
VK
ay
VK
VK
eR
eR
Qz
bo
jK
bh
zI
qQ
eR
Jo
eW
"}
(22,1,1) = {"
eW
Jo
Jo
Jo
Jo
Jo
VK
VK
VK
VK
VK
YF
Jo
VK
VK
eR
Ll
Ah
nH
eR
VK
VK
VK
Jo
eV
"}
(23,1,1) = {"
eW
Hb
Hb
Hb
Hb
Jo
Jo
Jo
Jo
Jo
Jo
YF
Jo
Jo
Jo
eR
eR
eR
eR
eR
Jo
Jo
Jo
Jo
eV
"}
(24,1,1) = {"
eW
Hb
Hb
CV
Hb
Hb
Jo
Jo
Jo
Jo
Jo
YF
YF
Jo
Jo
Jo
Jo
Jo
Jo
Jo
Jo
Jo
Jo
Jo
eW
"}
(25,1,1) = {"
eW
eW
eW
eW
eW
eW
eW
eV
eV
eW
gF
gF
eW
eW
eW
eW
eW
eV
eV
eV
eV
eW
eW
eW
eW
"}
