"a" = (/turf/template_noop,/area/space)
"b" = (/mob/living/simple_animal/hostile/giant_spider/hunter,/turf/template_noop,/area/space)
"c" = (/turf/simulated/wall/lead,/area/space)
"d" = (/obj/structure/sign/warning/radioactive,/turf/simulated/wall/lead,/area/space)
"e" = (/obj/structure/sign/warning/high_voltage,/turf/simulated/wall/lead,/area/space)
"f" = (/obj/structure/girder/displaced,/turf/snow/plating,/area/space)
"g" = (/mob/living/simple_animal/hostile/giant_spider/webslinger,/turf/simulated/floor/plating/sif/planetuse,/area/space)
"h" = (/turf/simulated/floor/plating/sif/planetuse,/area/space)
"i" = (/turf/snow/plating,/area/space)
"j" = (/mob/living/simple_animal/hostile/giant_spider{returns_home = 1},/turf/snow/plating,/area/space)
"k" = (/obj/structure/door_assembly/door_assembly_eng,/turf/simulated/floor/plating/sif/planetuse,/area/space)
"l" = (/obj/structure/frame,/turf/simulated/floor/plating/sif/planetuse,/area/space)
"m" = (/obj/machinery/power/smes/batteryrack/makeshift,/turf/simulated/floor/plating/sif/planetuse,/area/space)
"n" = (/mob/living/simple_animal/hostile/giant_spider/nurse{returns_home = 1},/turf/simulated/floor/plating/sif/planetuse,/area/space)
"o" = (/obj/structure/girder,/turf/snow/plating,/area/space)
"p" = (/mob/living/simple_animal/corgi/tamaskan,/turf/simulated/floor/plating/sif/planetuse,/area/space)
"q" = (/obj/item/weapon/caution/cone,/turf/template_noop,/area/space)
"r" = (/obj/structure/loot_pile/mecha/ripley,/turf/simulated/floor/plating/sif/planetuse,/area/space)
"s" = (/obj/item/weapon/card/id/engineering/atmos,/turf/simulated/floor/plating/sif/planetuse,/area/space)
"t" = (/obj/item/weapon/smes_coil/weak,/turf/simulated/floor/plating/sif/planetuse,/area/space)
"u" = (/obj/machinery/the_singularitygen/tesla,/turf/simulated/floor/plating/sif/planetuse,/area/space)
"v" = (/obj/structure/loot_pile/maint/technical,/turf/simulated/floor/plating/sif/planetuse,/area/space)
"w" = (/obj/machinery/door/airlock/engineering{name = "Engineering Hard Storage"; req_access = list(11); welded = 1},/turf/simulated/floor/plating/sif/planetuse,/area/space)
"x" = (/obj/item/weapon/extinguisher,/turf/simulated/floor/plating/sif/planetuse,/area/space)
"y" = (/obj/structure/loot_pile/maint/junk,/turf/simulated/floor/plating/sif/planetuse,/area/space)
"z" = (/obj/item/weapon/module/power_control,/obj/item/frame/apc{pixel_y = 32},/turf/simulated/floor/plating/sif/planetuse,/area/space)
"A" = (/obj/item/weapon/shovel,/turf/snow/plating,/area/space)
"B" = (/obj/structure/table/rack,/obj/item/device/analyzer,/turf/simulated/floor/plating/sif/planetuse,/area/space)
"C" = (/obj/item/weapon/airlock_electronics,/turf/simulated/floor/plating/sif/planetuse,/area/space)
"D" = (/obj/item/mecha_parts/mecha_equipment/tool/cable_layer,/turf/simulated/floor/plating/sif/planetuse,/area/space)
"E" = (/obj/structure/table/rack,/obj/item/integrated_circuit/memory/large,/turf/simulated/floor/plating/sif/planetuse,/area/space)
"F" = (/obj/item/device/flashlight,/turf/simulated/floor/plating/sif/planetuse,/area/space)
"G" = (/obj/item/device/multitool,/turf/simulated/floor/plating/sif/planetuse,/area/space)
"H" = (/obj/structure/table/rack,/obj/item/weapon/stock_parts/manipulator,/obj/item/weapon/stock_parts/manipulator,/turf/simulated/floor/plating/sif/planetuse,/area/space)
"I" = (/obj/structure/table/rack,/obj/item/weapon/stock_parts/scanning_module/adv,/obj/item/weapon/stock_parts/capacitor/super,/turf/simulated/floor/plating/sif/planetuse,/area/space)
"J" = (/obj/structure/table/rack,/obj/item/weapon/stock_parts/matter_bin,/obj/item/weapon/stock_parts/console_screen,/turf/simulated/floor/plating/sif/planetuse,/area/space)
"K" = (/obj/item/weapon/crowbar/rusted,/turf/template_noop,/area/space)
"L" = (/obj/item/weapon/wrench/rusted,/turf/template_noop,/area/space)
"M" = (/obj/structure/table/rack,/obj/item/weapon/tape_roll,/turf/simulated/floor/plating/sif/planetuse,/area/space)
"N" = (/obj/item/weapon/wrench/pipe,/turf/simulated/floor/plating/sif/planetuse,/area/space)
"O" = (/obj/machinery/power/emitter/old{dir = 1},/turf/simulated/floor/plating/sif/planetuse,/area/space)
"P" = (/obj/item/device/radio/ham,/turf/template_noop,/area/space)
"Q" = (/obj/machinery/portable_atmospherics/canister/nitrogen,/turf/simulated/floor/plating/sif/planetuse,/area/space)
"R" = (/obj/machinery/portable_atmospherics/canister/empty/nitrogen,/turf/simulated/floor/plating/sif/planetuse,/area/space)
"S" = (/obj/item/weapon/weldingtool/mini,/turf/simulated/floor/plating/sif/planetuse,/area/space)
"U" = (/obj/item/inflatable/torn,/turf/snow/plating,/area/space)
"V" = (/obj/item/weapon/storage/backpack/dufflebag/eng,/turf/simulated/floor/plating/sif/planetuse,/area/space)
"W" = (/obj/item/weapon/toolbox_tiles,/turf/simulated/floor/plating/sif/planetuse,/area/space)

(1,1,1) = {"
aaabaaaaaaaaL
aaaaaaaaaqaaa
aaccdcccecfaa
aacghzhstijaa
aakhlmuniAoaa
aacQVhpiUicaa
aachBlvCxncaa
aacDnMErhFcaK
aawShRWhhNkaa
aacGHIJlyOcaa
aaccecccdccaa
Paaaaaaaaaaaa
"}
