"a" = (/turf/template_noop,/area/template_noop)
"b" = (/turf/template_noop,/area/submap/Lab1)
"c" = (/turf/simulated/wall/r_wall,/area/submap/Lab1)
"d" = (/obj/structure/grille,/obj/structure/window/reinforced{dir = 1},/obj/structure/window/reinforced,/obj/machinery/door/firedoor/border_only,/obj/structure/window/reinforced{dir = 8},/turf/simulated/floor/plating,/area/submap/Lab1)
"e" = (/obj/structure/grille,/obj/structure/window/reinforced{dir = 1},/obj/structure/window/reinforced,/obj/machinery/door/firedoor/border_only,/turf/simulated/floor/plating,/area/submap/Lab1)
"f" = (/obj/structure/grille,/obj/structure/window/reinforced{dir = 1},/obj/structure/window/reinforced,/obj/structure/window/reinforced{dir = 4},/obj/machinery/door/firedoor/border_only,/turf/simulated/floor/plating,/area/submap/Lab1)
"g" = (/obj/machinery/space_heater,/turf/simulated/floor/tiled/steel_dirty,/area/submap/Lab1)
"h" = (/turf/simulated/floor/tiled/steel_dirty,/area/submap/Lab1)
"i" = (/obj/machinery/door/airlock,/turf/simulated/floor/tiled/steel_dirty,/area/submap/Lab1)
"j" = (/obj/machinery/light/small,/turf/simulated/floor/tiled/steel_dirty,/area/submap/Lab1)
"k" = (/obj/structure/table/standard,/obj/item/storage/toolbox,/obj/random/tool,/turf/simulated/floor/tiled/steel_dirty,/area/submap/Lab1)
"l" = (/obj/machinery/door/airlock/external,/turf/simulated/floor/tiled/steel_dirty,/area/submap/Lab1)
"m" = (/obj/structure/table/standard,/obj/random/tool,/obj/machinery/recharger,/turf/simulated/floor/tiled/steel_dirty,/area/submap/Lab1)
"n" = (/obj/machinery/vending/tool,/obj/machinery/light{dir = 4; icon_state = "tube1"},/turf/simulated/floor/tiled/steel_dirty,/area/submap/Lab1)
"o" = (/obj/structure/table/rack,/obj/item/clothing/suit/storage/hooded/wintercoat,/obj/item/clothing/shoes/boots/winter,/obj/machinery/light{dir = 8; icon_state = "tube1"},/turf/simulated/floor/tiled/steel_dirty,/area/submap/Lab1)
"p" = (/obj/structure/table/rack,/obj/item/clothing/suit/storage/hooded/wintercoat,/obj/item/clothing/shoes/boots/winter,/turf/simulated/floor/tiled/steel_dirty,/area/submap/Lab1)
"q" = (/obj/structure/table/standard,/obj/random/toolbox,/obj/item/cell/super,/turf/simulated/floor/tiled/steel_dirty,/area/submap/Lab1)
"r" = (/obj/structure/closet/toolcloset,/turf/simulated/floor/tiled/steel_dirty,/area/submap/Lab1)
"s" = (/obj/machinery/light/small{dir = 8},/turf/simulated/floor/tiled/steel_dirty,/area/submap/Lab1)
"t" = (/obj/structure/bed,/obj/item/bedsheet/brown,/turf/simulated/floor/tiled/steel_dirty,/area/submap/Lab1)
"u" = (/obj/machinery/power/apc{cell_type = /obj/item/cell/hyper; dir = 8; name = "Unknown APC"; operating = 0; pixel_x = -24},/obj/structure/cable{d2 = 4; icon_state = "0-4"},/turf/simulated/floor/tiled/steel_dirty,/area/submap/Lab1)
"v" = (/obj/machinery/power/terminal{dir = 4},/obj/structure/cable{d2 = 8; icon_state = "0-8"},/turf/simulated/floor/tiled/steel_dirty,/area/submap/Lab1)
"w" = (/obj/machinery/power/smes/buildable/point_of_interest,/turf/simulated/floor/tiled/steel_dirty,/area/submap/Lab1)
"x" = (/obj/structure/table/standard,/obj/item/paper{desc = "Gladstone for the last fucking time, We have crowbars for a REASON. Stop breaking in through the goddamn windows! We big red shiny doors for god's sakes!"},/turf/simulated/floor/tiled/steel_dirty,/area/submap/Lab1)
"y" = (/obj/structure/table/standard,/obj/item/device/flashlight/lamp,/turf/simulated/floor/tiled/steel_dirty,/area/submap/Lab1)
"z" = (/turf/simulated/floor,/area/submap/Lab1)
"A" = (/obj/machinery/vending/hydronutrients,/turf/simulated/floor/tiled/steel_dirty,/area/submap/Lab1)
"B" = (/obj/machinery/vending/hydroseeds,/turf/simulated/floor/tiled/steel_dirty,/area/submap/Lab1)
"C" = (/obj/machinery/light/small{dir = 4},/turf/simulated/floor/tiled/steel_dirty,/area/submap/Lab1)
"D" = (/obj/structure/table/standard,/obj/item/storage/toolbox/mechanical,/obj/random/tool/anom,/turf/simulated/floor/tiled/steel_dirty,/area/submap/Lab1)
"E" = (/obj/structure/table/standard,/obj/fiftyspawner/steel,/obj/fiftyspawner/glass,/turf/simulated/floor/tiled/steel_dirty,/area/submap/Lab1)
"F" = (/obj/structure/table/standard,/obj/item/device/multitool,/obj/item/clothing/glasses/welding{start_anomalous = 1},/turf/simulated/floor/tiled/steel_dirty,/area/submap/Lab1)
"G" = (/obj/machinery/portable_atmospherics/hydroponics,/turf/simulated/floor/tiled/steel_dirty,/area/submap/Lab1)
"H" = (/obj/structure/sink{dir = 4; icon_state = "sink"; pixel_x = 11; pixel_y = 0},/turf/simulated/floor/tiled/steel_dirty,/area/submap/Lab1)
"I" = (/obj/machinery/light{dir = 8; icon_state = "tube1"},/turf/simulated/floor/tiled/steel_dirty,/area/submap/Lab1)
"J" = (/obj/item/cell/super,/turf/simulated/floor/tiled/steel_dirty,/area/submap/Lab1)
"K" = (/obj/machinery/pros_fabricator,/turf/simulated/floor/tiled/steel_dirty,/area/submap/Lab1)
"L" = (/obj/machinery/portable_atmospherics/hydroponics,/obj/machinery/light{dir = 8; icon_state = "tube1"},/turf/simulated/floor/tiled/steel_dirty,/area/submap/Lab1)
"M" = (/obj/machinery/light{dir = 4; icon_state = "tube1"},/turf/simulated/floor/tiled/steel_dirty,/area/submap/Lab1)
"N" = (/obj/item/storage/bag/circuits,/obj/structure/table/standard,/turf/simulated/floor/tiled/steel_dirty,/area/submap/Lab1)
"O" = (/obj/machinery/light/small{dir = 1},/turf/simulated/floor/tiled/steel_dirty,/area/submap/Lab1)
"P" = (/obj/item/robot_parts/chest,/obj/item/robot_parts/l_arm,/obj/item/robot_parts/r_arm{start_anomalous = 1},/turf/simulated/floor/tiled/steel_dirty,/area/submap/Lab1)
"Q" = (/obj/structure/closet/crate/hydroponics,/turf/simulated/floor/tiled/steel_dirty,/area/submap/Lab1)
"R" = (/obj/structure/closet/secure_closet/hydroponics,/turf/simulated/floor/tiled/steel_dirty,/area/submap/Lab1)
"S" = (/obj/structure/table/standard,/obj/item/seeds/ambrosiavulgarisseed,/obj/item/material/knife/machete/hatchet,/turf/simulated/floor/tiled/steel_dirty,/area/submap/Lab1)
"T" = (/obj/machinery/vending/robotics,/turf/simulated/floor/tiled/steel_dirty,/area/submap/Lab1)
"U" = (/obj/structure/table/standard,/obj/machinery/cell_charger,/turf/simulated/floor/tiled/steel_dirty,/area/submap/Lab1)
"V" = (/obj/machinery/optable,/turf/simulated/floor/tiled/steel_dirty,/area/submap/Lab1)
"W" = (/obj/structure/table/standard,/obj/random/technology_scanner/anom,/turf/simulated/floor/tiled/steel_dirty,/area/submap/Lab1)
"X" = (/obj/structure/bed,/obj/item/bedsheet/green,/turf/simulated/floor/tiled/steel_dirty,/area/submap/Lab1)

(1,1,1) = {"
aaaaaaaaaaaaaaaaaaaa
abbbbbbbbbbbbbbbbbba
acdefcdeeeeeefcdefca
acghhihhjhhjhhihhWca
ackhgcdfcllcdfchhhca
acmhncbbchhcbbcohpca
acqhrcbbcshcbbcthXca
acuvwcbbchhcbbcxhyca
acdefcbbcllcbbcdefca
abbbbbbbbzzbbbbbbbba
abbbbbbbbzzbbbbbbbba
acdefcbbcllcbbcdefca
achABcbbchCcbbcDEFca
acGhHcbbchhcbbcIJKca
acLhMcdfcllcdfchhNca
acGhhihhOhhOhhihhPca
acQRScdeeeeeefcTUVca
acdefcbbbbbbbbcdefca
abbbbbbbbbbbbbbbbbba
aaaaaaaaaaaaaaaaaaaa
"}
