//MAP CONVERTED BY dmm2tgm.py THIS HEADER COMMENT PREVENTS RECONVERSION, DO NOT REMOVE
"bH" = (
/turf/simulated/floor/outdoors/rocks/caves,
/area/submap/Shelter1)
"cu" = (
/obj/item/material/shard/shrapnel,
/turf/simulated/floor/wood/sif,
/area/submap/Shelter1)
"dO" = (
/obj/structure/table/sifwoodentable,
/obj/item/flashlight/lamp/green,
/obj/random/cigarettes,
/obj/item/flame/lighter/random,
/turf/simulated/floor/wood/sif,
/area/submap/Shelter1)
"dZ" = (
/obj/structure/girder,
/obj/item/stack/material/wood/sif,
/turf/simulated/floor/plating,
/area/submap/Shelter1)
"ee" = (
/obj/item/stack/material/wood/sif,
/obj/item/stack/rods,
/obj/item/material/shard/shrapnel,
/turf/simulated/floor/plating,
/area/submap/Shelter1)
"eM" = (
/turf/simulated/wall/log_sif,
/area/submap/Shelter1)
"eT" = (
/obj/random/junk,
/turf/simulated/floor/wood/sif/broken,
/area/submap/Shelter1)
"gc" = (
/obj/structure/loot_pile/surface/bones,
/obj/item/radio{
	start_anomalous = 1
	},
/obj/machinery/light/small{
	dir = 1
	},
/turf/simulated/floor/wood/sif,
/area/submap/Shelter1)
"hd" = (
/obj/structure/table/sifwoodentable,
/obj/item/binoculars/spyglass,
/obj/structure/window/reinforced{
	dir = 4
	},
/turf/simulated/floor/wood/sif,
/area/submap/Shelter1)
"hl" = (
/obj/structure/flora/grass/both,
/turf/simulated/floor/outdoors/grass/sif,
/area/submap/Shelter1)
"iC" = (
/obj/structure/girder,
/turf/simulated/floor/plating,
/area/submap/Shelter1)
"jd" = (
/obj/structure/table/sifwoodentable,
/obj/random/mug,
/turf/simulated/floor/wood/sif,
/area/submap/Shelter1)
"lg" = (
/turf/template_noop,
/area/template_noop)
"lO" = (
/obj/structure/closet/secure_closet/freezer/fridge,
/turf/simulated/floor/wood/sif,
/area/submap/Shelter1)
"mc" = (
/obj/structure/toilet,
/turf/simulated/floor/tiled/neutral,
/area/submap/Shelter1)
"mw" = (
/obj/machinery/light/small{
	dir = 4
	},
/turf/simulated/floor/wood/sif,
/area/submap/Shelter1)
"sh" = (
/obj/item/stack/material/wood/sif,
/turf/simulated/floor/wood/sif/broken,
/area/submap/Shelter1)
"sv" = (
/obj/structure/fence,
/turf/simulated/floor/outdoors/dirt,
/area/submap/Shelter1)
"sI" = (
/obj/structure/fence{
	dir = 8;
	icon_state = "straight"
	},
/turf/simulated/floor/outdoors/grass/sif,
/area/submap/Shelter1)
"uf" = (
/obj/structure/table/sifwoodentable,
/obj/machinery/microwave,
/turf/simulated/floor/wood/sif,
/area/submap/Shelter1)
"uZ" = (
/obj/item/material/shard/shrapnel,
/obj/item/stack/material/steel,
/turf/simulated/floor/plating,
/area/submap/Shelter1)
"wc" = (
/obj/structure/fence/door{
	dir = 1
	},
/turf/simulated/floor/outdoors/dirt,
/area/submap/Shelter1)
"xq" = (
/obj/item/stack/material/wood/sif,
/obj/random/mob/robotic/hivebot/melee,
/obj/machinery/light/small{
	dir = 1
	},
/turf/simulated/floor/wood/sif/broken,
/area/submap/Shelter1)
"xv" = (
/turf/simulated/floor/tiled/neutral,
/area/submap/Shelter1)
"xQ" = (
/obj/structure/flora/grass/brown,
/turf/simulated/floor/outdoors/grass/sif,
/area/submap/Shelter1)
"ye" = (
/obj/effect/decal/cleanable/blood/oil,
/obj/item/stack/material/steel,
/turf/simulated/floor/tiled/neutral,
/area/submap/Shelter1)
"yg" = (
/turf/simulated/floor/outdoors/grass/sif,
/area/submap/Shelter1)
"yr" = (
/obj/effect/decal/remains/human,
/turf/simulated/floor/outdoors/dirt,
/area/submap/Shelter1)
"yD" = (
/obj/structure/fireplace,
/turf/simulated/floor/wood/sif,
/area/submap/Shelter1)
"zh" = (
/obj/effect/decal/cleanable/blood/oil,
/obj/effect/spawner/gibs/robot,
/turf/simulated/floor/reinforced,
/area/submap/Shelter1)
"zv" = (
/obj/structure/fence/cut/large,
/turf/simulated/floor/outdoors/dirt,
/area/submap/Shelter1)
"zz" = (
/obj/effect/spawner/gibs/robot,
/turf/simulated/floor/reinforced,
/area/submap/Shelter1)
"zX" = (
/obj/fiftyspawner/log/sif,
/turf/simulated/floor/wood/sif,
/area/submap/Shelter1)
"AT" = (
/obj/structure/simple_door/sifwood,
/turf/simulated/floor/wood/sif,
/area/submap/Shelter1)
"AU" = (
/obj/random/mob/robotic/hivebot/laser,
/turf/simulated/floor/wood/sif,
/area/submap/Shelter1)
"BJ" = (
/obj/structure/window/basic/full,
/obj/structure/curtain/black,
/turf/simulated/floor/wood/sif,
/area/submap/Shelter1)
"Fa" = (
/turf/simulated/wall/titanium,
/area/submap/Shelter1)
"Fp" = (
/turf/template_noop,
/area/submap/Shelter1)
"HH" = (
/turf/simulated/floor/wood/sif/broken,
/area/submap/Shelter1)
"HT" = (
/obj/structure/table/sifwoodentable,
/obj/structure/window/reinforced{
	dir = 4
	},
/obj/random/coin/anom,
/turf/simulated/floor/wood/sif,
/area/submap/Shelter1)
"IT" = (
/obj/random/projectile/scrapped_shotgun,
/obj/random/toolbox,
/obj/effect/spawner/gibs/human,
/turf/simulated/floor/wood/sif,
/area/submap/Shelter1)
"Je" = (
/obj/structure/closet/cabinet,
/obj/item/mop,
/obj/random/soap,
/obj/random/medical,
/obj/item/stock_parts/spring,
/obj/machinery/light/small{
	dir = 1
	},
/turf/simulated/floor/tiled/neutral,
/area/submap/Shelter1)
"Jp" = (
/obj/effect/decal/cleanable/blood,
/turf/simulated/floor/outdoors/dirt,
/area/submap/Shelter1)
"JD" = (
/obj/structure/closet/cabinet,
/obj/item/clothing/accessory/medal/permit/gun/planetside,
/obj/item/clothing/suit/armor/pcarrier/light,
/obj/item/clothing/mask/gas/half,
/obj/item/clothing/shoes/boots/winter,
/obj/item/material/knife/machete,
/obj/item/storage/wallet/random,
/turf/simulated/floor/wood/sif,
/area/submap/Shelter1)
"JR" = (
/turf/simulated/floor/outdoors/dirt,
/area/submap/Shelter1)
"Kf" = (
/obj/structure/fence,
/turf/simulated/floor/outdoors/rocks/caves,
/area/submap/Shelter1)
"Lp" = (
/obj/effect/decal/cleanable/blood,
/turf/simulated/floor/outdoors/rocks/caves,
/area/submap/Shelter1)
"LB" = (
/obj/random/trash,
/obj/random/junk,
/obj/random/mob/robotic/hivebot/melee,
/turf/simulated/floor/wood/sif,
/area/submap/Shelter1)
"Mw" = (
/obj/structure/loot_pile/maint/trash,
/turf/simulated/floor/outdoors/dirt,
/area/submap/Shelter1)
"MR" = (
/obj/structure/girder/displaced,
/turf/simulated/floor/plating,
/area/submap/Shelter1)
"Nx" = (
/obj/structure/fence/corner{
	dir = 4
	},
/turf/simulated/floor/outdoors/grass/sif,
/area/submap/Shelter1)
"OO" = (
/obj/structure/loot_pile/maint/junk,
/turf/simulated/floor/outdoors/dirt,
/area/submap/Shelter1)
"Pg" = (
/turf/simulated/floor/outdoors/dirt,
/area/template_noop)
"PS" = (
/turf/simulated/floor/wood/sif,
/area/submap/Shelter1)
"Ro" = (
/obj/structure/sink{
	pixel_y = 17
	},
/obj/structure/mirror{
	pixel_y = 32
	},
/turf/simulated/floor/tiled/neutral,
/area/submap/Shelter1)
"RV" = (
/obj/item/material/shard/shrapnel,
/turf/simulated/floor/reinforced,
/area/submap/Shelter1)
"Vv" = (
/obj/item/stack/material/steel,
/obj/machinery/light/small{
	dir = 8
	},
/turf/simulated/floor/wood/sif/broken,
/area/submap/Shelter1)
"WG" = (
/obj/item/stack/material/wood/sif,
/obj/item/material/shard/shrapnel,
/turf/simulated/floor/outdoors/rocks/caves,
/area/submap/Shelter1)
"WI" = (
/turf/simulated/floor/reinforced,
/area/submap/Shelter1)
"Xl" = (
/obj/structure/fence,
/turf/simulated/floor/outdoors/grass/sif,
/area/submap/Shelter1)
"YM" = (
/obj/structure/flora/ausbushes/brflowers,
/turf/simulated/floor/outdoors/grass/sif,
/area/submap/Shelter1)
"YV" = (
/obj/item/stack/material/steel,
/turf/simulated/floor/wood/sif,
/area/submap/Shelter1)
"Zb" = (
/obj/structure/bed/chair/comfy/brown,
/turf/simulated/floor/wood/sif,
/area/submap/Shelter1)
"Zj" = (
/obj/structure/bed/double/padded,
/obj/item/bedsheet/mimedouble,
/turf/simulated/floor/wood/sif,
/area/submap/Shelter1)

(1,1,1) = {"
lg
lg
lg
lg
lg
lg
lg
lg
lg
lg
lg
lg
lg
lg
lg
"}
(2,1,1) = {"
lg
eM
eM
BJ
eM
eM
yg
hl
yg
Fp
Fp
xQ
yg
Fp
lg
"}
(3,1,1) = {"
lg
eM
gc
Zb
dO
eM
eM
eM
eM
BJ
BJ
BJ
eM
Fp
lg
"}
(4,1,1) = {"
lg
BJ
PS
cu
PS
eM
hd
HT
eM
uf
lO
jd
eM
yg
lg
"}
(5,1,1) = {"
lg
eM
JD
Zj
AU
AT
PS
sh
PS
PS
cu
PS
eM
Fp
lg
"}
(6,1,1) = {"
lg
eM
eM
eM
ee
eM
xq
WI
iC
IT
mw
LB
eM
Fp
lg
"}
(7,1,1) = {"
lg
Fp
eM
Ro
xv
MR
Fa
RV
Fa
eM
eM
PS
eM
yg
lg
"}
(8,1,1) = {"
lg
OO
eM
mc
ye
Fa
Fa
zz
Fa
Fa
Vv
cu
BJ
YM
Pg
"}
(9,1,1) = {"
Pg
Mw
eM
Je
WI
WI
zz
zh
WI
WI
WI
YV
AT
JR
lg
"}
(10,1,1) = {"
Pg
JR
eM
dZ
bH
Fa
Fa
zz
MR
Fa
sh
PS
BJ
YM
lg
"}
(11,1,1) = {"
lg
JR
wc
Jp
JR
WG
iC
WI
dZ
eT
PS
PS
eM
yg
lg
"}
(12,1,1) = {"
lg
hl
sI
Fp
yr
JR
Lp
WI
uZ
HH
yD
zX
eM
yg
lg
"}
(13,1,1) = {"
lg
Fp
Nx
Xl
Xl
sv
zv
Kf
eM
BJ
eM
BJ
eM
Fp
lg
"}
(14,1,1) = {"
lg
Fp
Fp
Fp
Fp
Fp
JR
JR
xQ
yg
yg
Fp
Fp
Fp
lg
"}
(15,1,1) = {"
lg
lg
lg
lg
lg
lg
lg
lg
lg
lg
lg
lg
lg
lg
lg
"}
