//MAP CONVERTED BY dmm2tgm.py THIS HEADER COMMENT PREVENTS RECONVERSION, DO NOT REMOVE
"ct" = (
/obj/structure/girder/reinforced,
/obj/item/stack/material/steel,
/obj/item/stack/material/steel,
/turf/simulated/floor/plating,
/area/submap/XenoHive)
"cJ" = (
/turf/simulated/floor/tiled/techfloor,
/area/submap/XenoHive)
"cP" = (
/obj/machinery/optable,
/obj/effect/decal/cleanable/blood,
/obj/machinery/light/small{
	dir = 8
	},
/turf/simulated/floor/tiled/white,
/area/submap/XenoHive)
"dG" = (
/obj/effect/floor_decal/rust,
/obj/structure/loot_pile/mecha/gygax/dark/adv,
/turf/simulated/floor/tiled/milspec/dark,
/area/submap/XenoHive)
"ec" = (
/obj/machinery/light/small{
	dir = 1
	},
/mob/living/simple_mob/animal/space/alien/drone,
/turf/simulated/floor/tiled/milspec/dark,
/area/submap/XenoHive)
"ee" = (
/obj/structure/grille/broken,
/obj/item/material/shard/phoron,
/turf/simulated/floor/tiled/techfloor/grid,
/area/submap/XenoHive)
"eB" = (
/obj/effect/alien/weeds,
/obj/effect/landmark/corpse/hedberg,
/obj/random/maintenance/security,
/obj/random/projectile/sec,
/obj/effect/decal/cleanable/blood,
/turf/simulated/floor/tiled/milspec,
/area/submap/XenoHive)
"eY" = (
/obj/effect/alien/weeds,
/obj/structure/simple_door/resin,
/turf/simulated/floor/tiled/milspec/dark,
/area/submap/XenoHive)
"fz" = (
/obj/effect/alien/weeds,
/obj/structure/loot_pile/mecha/durand,
/turf/simulated/floor/plating,
/area/submap/XenoHive)
"fC" = (
/obj/structure/simple_door/resin,
/obj/effect/alien/weeds,
/turf/simulated/floor/tiled/milspec/dark,
/area/submap/XenoHive)
"fM" = (
/turf/simulated/floor/outdoors/dirt,
/area/submap/XenoHive)
"fT" = (
/obj/effect/alien/weeds,
/turf/simulated/floor/tiled/milspec,
/area/submap/XenoHive)
"fX" = (
/turf/simulated/floor/tiled/milspec,
/area/submap/XenoHive)
"go" = (
/turf/simulated/floor/outdoors/dirt,
/area/template_noop)
"gu" = (
/obj/item/bodybag,
/turf/simulated/floor/tiled/milspec/dark,
/area/submap/XenoHive)
"hL" = (
/obj/effect/alien/weeds,
/obj/structure/loot_pile/maint/technical,
/turf/simulated/floor/tiled/milspec/dark,
/area/submap/XenoHive)
"hQ" = (
/obj/structure/salvageable/bliss,
/turf/simulated/floor/tiled/milspec/raised,
/area/submap/XenoHive)
"iv" = (
/obj/random/junk,
/turf/simulated/floor/tiled/milspec/dark,
/area/submap/XenoHive)
"jr" = (
/obj/machinery/light/small,
/turf/simulated/floor/tiled/milspec/dark,
/area/submap/XenoHive)
"jK" = (
/obj/effect/floor_decal/milspec/box,
/obj/machinery/telecomms/receiver,
/turf/simulated/floor/tiled/milspec/raised,
/area/submap/XenoHive)
"kg" = (
/obj/effect/alien/weeds,
/obj/item/ore/magmellite,
/turf/simulated/floor/tiled/milspec/dark,
/area/submap/XenoHive)
"km" = (
/obj/effect/alien/weeds,
/obj/effect/alien/weeds,
/turf/simulated/floor/tiled/milspec,
/area/submap/XenoHive)
"kK" = (
/obj/structure/table/steel_reinforced,
/obj/effect/alien/weeds,
/obj/machinery/portable_atmospherics/powered/reagent_distillery/industrial,
/turf/simulated/floor/tiled/milspec/dark,
/area/submap/XenoHive)
"lb" = (
/obj/effect/alien/weeds,
/obj/structure/bed/nest,
/turf/simulated/floor/tiled/white,
/area/submap/XenoHive)
"lD" = (
/obj/effect/alien/weeds,
/obj/effect/alien/resin/wall,
/turf/simulated/floor/plating,
/area/submap/XenoHive)
"lH" = (
/obj/effect/alien/weeds,
/obj/effect/alien/resin/membrane,
/turf/simulated/floor/plating,
/area/submap/XenoHive)
"mf" = (
/obj/effect/alien/weeds,
/mob/living/simple_mob/animal/space/alien/drone,
/turf/simulated/floor/tiled/white,
/area/submap/XenoHive)
"mi" = (
/obj/structure/table/steel_reinforced,
/obj/effect/floor_decal/industrial/warning{
	dir = 8
	},
/obj/random/tool/power,
/turf/simulated/floor/tiled/white,
/area/submap/XenoHive)
"mV" = (
/obj/structure/salvageable/autolathe,
/turf/simulated/floor/tiled/milspec/dark,
/area/submap/XenoHive)
"mW" = (
/obj/structure/grille,
/obj/structure/window/phoronreinforced/full,
/turf/simulated/floor/tiled/techfloor/grid,
/area/submap/XenoHive)
"nd" = (
/obj/effect/landmark/corpse/hedberg/merc,
/obj/random/maintenance/security,
/obj/random/contraband,
/obj/random/multiple/gun/projectile/rifle,
/obj/effect/decal/cleanable/blood,
/turf/simulated/floor/tiled/white,
/area/submap/XenoHive)
"nG" = (
/obj/machinery/light/small{
	dir = 1
	},
/turf/simulated/floor/tiled/milspec/dark,
/area/submap/XenoHive)
"nK" = (
/obj/effect/alien/weeds,
/obj/structure/simple_door/resin,
/obj/effect/decal/cleanable/blood/drip,
/turf/simulated/floor/tiled/milspec/dark,
/area/submap/XenoHive)
"nV" = (
/obj/structure/grille,
/obj/structure/window/reinforced/full,
/turf/simulated/floor/tiled/white,
/area/submap/XenoHive)
"oC" = (
/obj/machinery/light/small,
/obj/structure/table/steel_reinforced,
/turf/simulated/floor/tiled/milspec/dark,
/area/submap/XenoHive)
"oY" = (
/obj/effect/landmark/corpse/sifguard,
/turf/simulated/floor/tiled/milspec/dark,
/area/submap/XenoHive)
"pk" = (
/obj/machinery/floodlight,
/turf/simulated/floor/tiled/milspec/dark,
/area/submap/XenoHive)
"qe" = (
/obj/structure/sign/warning/secure_area,
/turf/simulated/wall/r_wall,
/area/submap/XenoHive)
"rg" = (
/obj/structure/girder/displaced,
/turf/simulated/floor/plating,
/area/submap/XenoHive)
"rp" = (
/turf/simulated/mineral/ignore_mapgen,
/area/submap/XenoHive)
"rB" = (
/mob/living/simple_mob/animal/space/alien/drone,
/turf/simulated/floor/tiled/white,
/area/submap/XenoHive)
"rW" = (
/obj/effect/alien/weeds,
/obj/effect/landmark/corpse/hedberg,
/obj/random/maintenance/security,
/obj/random/projectile/sec,
/obj/effect/decal/cleanable/blood,
/turf/simulated/floor/tiled/milspec/raised,
/area/submap/XenoHive)
"tS" = (
/obj/structure/table/steel_reinforced,
/obj/random/maintenance/anom,
/obj/structure/noticeboard/anomaly,
/turf/simulated/floor/tiled/white,
/area/submap/XenoHive)
"ut" = (
/obj/effect/alien/weeds,
/obj/structure/bed/nest,
/turf/simulated/floor/tiled/techfloor,
/area/submap/XenoHive)
"uH" = (
/obj/effect/alien/weeds,
/obj/structure/table,
/turf/simulated/floor/tiled/white,
/area/submap/XenoHive)
"uI" = (
/obj/structure/salvageable/server,
/turf/simulated/floor/tiled/milspec/raised,
/area/submap/XenoHive)
"vG" = (
/obj/machinery/door/airlock/highsecurity,
/obj/effect/alien/weeds,
/turf/simulated/floor/tiled/dark,
/area/submap/XenoHive)
"vU" = (
/obj/item/clothing/suit/armor/pcarrier/tan/tactical,
/obj/effect/alien/weeds,
/turf/simulated/floor/tiled/milspec/dark,
/area/submap/XenoHive)
"wT" = (
/obj/structure/table/steel_reinforced,
/obj/structure/salvageable/personal,
/turf/simulated/floor/tiled/white,
/area/submap/XenoHive)
"ym" = (
/obj/effect/alien/weeds,
/obj/effect/landmark/corpse/hedberg,
/obj/random/maintenance/security,
/obj/random/projectile/scrapped_shotgun,
/obj/effect/decal/cleanable/blood,
/turf/simulated/floor/tiled/white,
/area/submap/XenoHive)
"yq" = (
/obj/effect/alien/weeds,
/obj/effect/alien/weeds,
/turf/simulated/floor/tiled/milspec/dark,
/area/submap/XenoHive)
"yE" = (
/obj/structure/simple_door/resin,
/obj/effect/alien/weeds,
/turf/simulated/floor/plating,
/area/submap/XenoHive)
"AC" = (
/obj/effect/alien/resin/wall,
/turf/simulated/floor/tiled/milspec,
/area/submap/XenoHive)
"AK" = (
/obj/structure/table/steel_reinforced,
/obj/item/storage/firstaid/surgery/simple,
/obj/item/autopsy_scanner,
/turf/simulated/floor/tiled/white,
/area/submap/XenoHive)
"Bf" = (
/mob/living/simple_mob/animal/space/alien/drone,
/turf/simulated/floor/tiled/techfloor,
/area/submap/XenoHive)
"Bk" = (
/obj/structure/bed/chair/office/dark{
	dir = 8
	},
/obj/structure/loot_pile/surface/bones,
/turf/simulated/floor/tiled/milspec/dark,
/area/submap/XenoHive)
"Bv" = (
/obj/random/obstruction,
/turf/simulated/floor/outdoors/dirt,
/area/submap/XenoHive)
"BQ" = (
/obj/structure/prop/blackbox/quarantined_shuttle,
/obj/machinery/light/small{
	dir = 1
	},
/turf/simulated/floor/tiled/white,
/area/submap/XenoHive)
"BT" = (
/obj/effect/alien/weeds,
/turf/simulated/floor/tiled/milspec/dark,
/area/submap/XenoHive)
"Cx" = (
/obj/effect/alien/weeds,
/obj/structure/table/steel_reinforced,
/obj/fiftyspawner/phoron,
/turf/simulated/floor/tiled/milspec/dark,
/area/submap/XenoHive)
"Cy" = (
/obj/effect/alien/weeds,
/turf/simulated/floor/tiled/techfloor,
/area/submap/XenoHive)
"CF" = (
/obj/effect/alien/weeds,
/obj/effect/alien/weeds,
/obj/structure/simple_door/resin,
/turf/simulated/floor/tiled/milspec/dark,
/area/submap/XenoHive)
"El" = (
/obj/effect/alien/weeds,
/obj/structure/table/steel_reinforced,
/turf/simulated/floor/tiled/milspec/dark,
/area/submap/XenoHive)
"Fc" = (
/obj/machinery/light/small{
	dir = 4
	},
/obj/effect/alien/weeds,
/turf/simulated/floor/tiled/milspec/dark,
/area/submap/XenoHive)
"FQ" = (
/turf/simulated/wall/skipjack,
/area/submap/XenoHive)
"Gt" = (
/obj/structure/grille,
/obj/effect/alien/weeds,
/turf/simulated/floor/tiled/techfloor/grid,
/area/submap/XenoHive)
"GO" = (
/obj/structure/bed/chair/office/dark{
	dir = 1
	},
/obj/structure/loot_pile/surface/bones,
/turf/simulated/floor/tiled/white,
/area/submap/XenoHive)
"GV" = (
/obj/structure/table/steel_reinforced,
/obj/effect/alien/weeds,
/obj/item/cell/device/weapon/recharge,
/turf/simulated/floor/tiled/white,
/area/submap/XenoHive)
"Hb" = (
/obj/structure/safe,
/obj/item/organ/internal/augment/armmounted,
/obj/item/organ/internal/kidneys/vox,
/obj/item/organ/internal/eyes/replicant,
/obj/effect/alien/weeds,
/turf/simulated/floor/tiled/white,
/area/submap/XenoHive)
"Hg" = (
/obj/effect/alien/weeds,
/obj/effect/landmark/corpse/hedberg/merc,
/obj/random/contraband,
/obj/random/maintenance/security,
/obj/random/projectile/scrapped_bulldog,
/obj/effect/decal/cleanable/blood,
/obj/item/melee/energy/axe/charge/loaded,
/turf/simulated/floor/tiled/techfloor,
/area/submap/XenoHive)
"Ii" = (
/obj/structure/table/rack,
/obj/random/medical/anom,
/turf/simulated/floor/tiled/milspec,
/area/submap/XenoHive)
"Iu" = (
/obj/effect/floor_decal/milspec/box,
/obj/machinery/telecomms/broadcaster,
/turf/simulated/floor/tiled/milspec/raised,
/area/submap/XenoHive)
"Jm" = (
/obj/effect/alien/weeds,
/obj/structure/bed/nest,
/obj/item/toy/plushie/face_hugger,
/turf/simulated/floor/plating,
/area/submap/XenoHive)
"Jn" = (
/obj/structure/table/steel_reinforced,
/obj/effect/floor_decal/industrial/warning{
	dir = 8
	},
/obj/item/storage/backpack/holding,
/turf/simulated/floor/tiled/white,
/area/submap/XenoHive)
"JL" = (
/obj/effect/alien/weeds,
/obj/structure/bed/nest,
/turf/simulated/floor/plating,
/area/submap/XenoHive)
"KL" = (
/obj/effect/alien/weeds,
/obj/structure/bed/nest,
/turf/simulated/floor/tiled/milspec,
/area/submap/XenoHive)
"KM" = (
/obj/effect/floor_decal/industrial/warning{
	dir = 8
	},
/turf/simulated/floor/tiled/white,
/area/submap/XenoHive)
"Lc" = (
/obj/effect/floor_decal/milspec/box,
/obj/structure/prop/transmitter,
/turf/simulated/floor/tiled/milspec/raised,
/area/submap/XenoHive)
"Lg" = (
/obj/effect/alien/weeds,
/obj/item/ore/magmellite,
/turf/simulated/floor/plating,
/area/submap/XenoHive)
"Ln" = (
/obj/effect/alien/resin/wall,
/turf/simulated/wall/r_wall,
/area/submap/XenoHive)
"Lq" = (
/obj/effect/alien/resin/wall,
/turf/simulated/wall/skipjack,
/area/submap/XenoHive)
"LD" = (
/obj/effect/spawner/gibs/human,
/turf/simulated/floor/tiled/milspec/dark,
/area/submap/XenoHive)
"LR" = (
/obj/random/toolbox/anom,
/turf/simulated/floor/tiled/milspec/dark,
/area/submap/XenoHive)
"LX" = (
/obj/structure/foamedmetal,
/turf/simulated/floor/outdoors/dirt,
/area/submap/XenoHive)
"Mt" = (
/turf/simulated/floor/tiled/milspec/dark,
/area/submap/XenoHive)
"MN" = (
/obj/effect/alien/weeds,
/mob/living/simple_mob/animal/space/alien,
/turf/simulated/floor/tiled/techfloor,
/area/submap/XenoHive)
"Nw" = (
/mob/living/simple_mob/animal/space/alien,
/turf/simulated/floor/tiled/milspec,
/area/submap/XenoHive)
"Nz" = (
/obj/effect/floor_decal/rust,
/turf/simulated/floor/tiled/milspec/dark,
/area/submap/XenoHive)
"NK" = (
/obj/effect/decal/cleanable/blood/drip,
/turf/simulated/floor/tiled/milspec/dark,
/area/submap/XenoHive)
"Oc" = (
/obj/structure/table/rack/shelf,
/obj/random/tech_supply,
/turf/simulated/floor/tiled/milspec/dark,
/area/submap/XenoHive)
"Ot" = (
/obj/effect/alien/weeds,
/obj/effect/alien/weeds,
/obj/structure/bed/nest,
/turf/simulated/floor/tiled/white,
/area/submap/XenoHive)
"Ov" = (
/obj/structure/table/steel_reinforced,
/obj/item/portable_destructive_analyzer,
/turf/simulated/floor/tiled/milspec/dark,
/area/submap/XenoHive)
"Pd" = (
/obj/effect/alien/weeds,
/turf/simulated/floor/tiled/white,
/area/submap/XenoHive)
"Qn" = (
/obj/effect/alien/weeds,
/obj/structure/table/steel_reinforced,
/obj/random/tool/power,
/obj/random/powercell/anom,
/turf/simulated/floor/tiled/white,
/area/submap/XenoHive)
"QO" = (
/obj/structure/table/steel_reinforced,
/obj/effect/floor_decal/industrial/warning{
	dir = 8
	},
/obj/random/maintenance/medical,
/obj/random/maintenance/medical,
/turf/simulated/floor/tiled/white,
/area/submap/XenoHive)
"Ri" = (
/obj/effect/spawner/gibs/human,
/obj/structure/grille/broken,
/turf/simulated/floor/tiled/techfloor/grid,
/area/submap/XenoHive)
"Rj" = (
/turf/simulated/wall/r_wall,
/area/submap/XenoHive)
"Rp" = (
/obj/effect/alien/resin/membrane,
/turf/simulated/floor/plating,
/area/submap/XenoHive)
"RA" = (
/obj/effect/decal/cleanable/blood/drip,
/turf/simulated/floor/outdoors/dirt,
/area/submap/XenoHive)
"RG" = (
/obj/structure/table/rack/shelf,
/obj/random/maintenance/engineering,
/turf/simulated/floor/tiled/milspec/dark,
/area/submap/XenoHive)
"SB" = (
/obj/effect/alien/weeds,
/turf/simulated/floor/outdoors/dirt,
/area/submap/XenoHive)
"ST" = (
/obj/structure/salvageable/server,
/obj/effect/alien/weeds,
/turf/simulated/floor/tiled/milspec/raised,
/area/submap/XenoHive)
"SU" = (
/mob/living/simple_mob/animal/space/alien,
/turf/simulated/floor/tiled/milspec/dark,
/area/submap/XenoHive)
"TZ" = (
/obj/effect/alien/weeds,
/obj/structure/loot_pile/surface/bones,
/turf/simulated/floor/tiled/techfloor/grid,
/area/submap/XenoHive)
"Uv" = (
/obj/effect/alien/resin/wall,
/obj/effect/alien/weeds,
/turf/simulated/wall/r_wall,
/area/submap/XenoHive)
"UJ" = (
/obj/machinery/light/small/emergency{
	dir = 8
	},
/turf/simulated/floor/tiled/milspec/dark,
/area/submap/XenoHive)
"UR" = (
/turf/template_noop,
/area/template_noop)
"UV" = (
/obj/effect/landmark/corpse/hedberg,
/obj/structure/bed/roller,
/obj/effect/decal/cleanable/blood,
/obj/random/projectile/scrapped_gun,
/turf/simulated/floor/tiled/milspec,
/area/submap/XenoHive)
"VG" = (
/obj/item/organ/internal/intestine,
/obj/item/organ/internal/kidneys,
/obj/structure/closet/crate/freezer,
/turf/simulated/floor/tiled/white,
/area/submap/XenoHive)
"VK" = (
/turf/simulated/floor/tiled/white,
/area/submap/XenoHive)
"VS" = (
/obj/structure/table/rack/shelf,
/obj/random/powercell,
/turf/simulated/floor/tiled/milspec/dark,
/area/submap/XenoHive)
"Wi" = (
/obj/effect/alien/weeds,
/obj/item/ore/magmellite,
/mob/living/simple_mob/animal/space/alien,
/turf/simulated/floor/tiled/milspec/dark,
/area/submap/XenoHive)
"WG" = (
/obj/effect/alien/weeds,
/obj/item/ore/magmellite,
/turf/simulated/floor/tiled/white,
/area/submap/XenoHive)
"WR" = (
/obj/effect/alien/weeds,
/mob/living/simple_mob/animal/space/alien,
/turf/simulated/floor/plating,
/area/submap/XenoHive)
"WU" = (
/obj/effect/alien/weeds,
/obj/structure/bed/nest,
/turf/simulated/floor/tiled/milspec/dark,
/area/submap/XenoHive)
"Xc" = (
/obj/effect/alien/weeds,
/obj/structure/bed/chair/office/dark{
	dir = 4
	},
/turf/simulated/floor/tiled/milspec/dark,
/area/submap/XenoHive)
"Xr" = (
/obj/structure/simple_door/resin,
/obj/effect/alien/weeds,
/turf/simulated/floor/tiled/white,
/area/submap/XenoHive)
"Xs" = (
/obj/effect/alien/weeds,
/obj/structure/loot_pile/surface/bones,
/turf/simulated/floor/tiled/white,
/area/submap/XenoHive)
"XW" = (
/obj/effect/alien/weeds,
/turf/simulated/floor/plating,
/area/submap/XenoHive)
"Yp" = (
/obj/effect/alien/weeds,
/obj/effect/spawner/gibs/human,
/turf/simulated/floor/tiled/techfloor,
/area/submap/XenoHive)
"Yt" = (
/mob/living/simple_mob/animal/space/alien/drone,
/turf/simulated/floor/tiled/milspec,
/area/submap/XenoHive)
"ZA" = (
/obj/effect/decal/cleanable/vomit,
/turf/simulated/floor/tiled/milspec,
/area/submap/XenoHive)

(1,1,1) = {"
UR
UR
UR
UR
UR
UR
UR
UR
UR
UR
UR
UR
UR
UR
UR
UR
UR
UR
UR
UR
UR
UR
UR
UR
UR
"}
(2,1,1) = {"
UR
UR
UR
rp
rp
rp
rp
rp
rp
rp
rp
rp
UR
UR
rp
rp
rp
rp
rp
rp
rp
UR
UR
UR
UR
"}
(3,1,1) = {"
UR
UR
rp
rp
Rj
Rj
Rj
Rj
Rj
Rj
Rj
Rj
rp
rp
rp
Rj
Rj
Rj
Ln
Ln
rp
rp
rp
UR
UR
"}
(4,1,1) = {"
UR
rp
rp
Rj
Rj
Lq
Lq
Lq
Lq
Lq
Lq
Lq
Rj
rp
Rj
Rj
AK
cP
uH
Ln
Ln
rp
rp
UR
UR
"}
(5,1,1) = {"
UR
rp
rp
Rj
Lq
Lq
ut
ut
ut
ut
ut
Lq
Lq
Ln
Ln
VG
VK
Pd
lb
Hb
Ln
Ln
rp
rp
UR
"}
(6,1,1) = {"
UR
rp
rp
Rj
Lq
ut
Yp
Cy
MN
Cy
MN
ut
Lq
fz
Ln
nV
Ot
Pd
mf
Pd
lb
Ln
rp
rp
UR
"}
(7,1,1) = {"
UR
rp
rp
Rj
Lq
Cy
MN
Iu
Lc
jK
Hg
Cy
Lq
XW
WU
lb
mf
Pd
Pd
Pd
lb
Ln
rp
rp
UR
"}
(8,1,1) = {"
UR
rp
rp
Rj
Lq
ut
Cy
Cy
cJ
Bf
Cy
ut
Lq
XW
XW
Pd
Pd
Pd
lb
WG
Xs
Ln
rp
rp
UR
"}
(9,1,1) = {"
UR
rp
rp
Rj
FQ
FQ
mW
ee
Ri
TZ
Gt
Rp
Lq
JL
Jm
fT
Ln
km
KL
eB
AC
Ln
rp
rp
UR
"}
(10,1,1) = {"
UR
rp
rp
Rj
FQ
Jn
QO
mi
KM
Pd
Qn
GV
Lq
lD
Lg
BT
BT
yq
BT
WU
BT
Ln
rp
rp
UR
"}
(11,1,1) = {"
UR
rp
rp
Rj
FQ
tS
rB
nd
VK
VK
Pd
Pd
yE
XW
lD
El
BT
WU
Xc
BT
Ov
Rj
rp
rp
UR
"}
(12,1,1) = {"
UR
rp
rp
Rj
FQ
wT
GO
VK
lb
Pd
Pd
lb
Lq
XW
lH
El
BT
Cx
kK
iv
oC
Rj
rp
rp
UR
"}
(13,1,1) = {"
UR
rp
rp
Rj
Rj
FQ
BQ
Pd
Pd
ym
lb
Lq
Lq
XW
lH
hL
BT
BT
Mt
Mt
mV
Rj
rp
fM
UR
"}
(14,1,1) = {"
UR
rp
rp
Rj
Rj
Rj
Lq
Lq
Xr
Lq
Ln
Lq
WR
XW
Ln
Ln
Uv
CF
Uv
Rj
Rj
Rj
rp
fM
UR
"}
(15,1,1) = {"
UR
UR
rp
rp
rp
Rj
Uv
BT
BT
Wi
Ln
Ln
XW
Ln
Ln
Rj
Mt
BT
BT
Ln
Ln
rp
fM
UR
UR
"}
(16,1,1) = {"
UR
rp
rp
rp
Rj
Rj
nG
Mt
BT
BT
BT
Ln
fC
Ln
Rj
UJ
Mt
Mt
BT
BT
Ln
Ln
rp
UR
UR
"}
(17,1,1) = {"
UR
rp
rp
Rj
Rj
uI
Mt
uI
Mt
ST
BT
rW
kg
Ln
pk
Mt
Nw
ZA
fX
BT
BT
Ln
qe
rp
UR
"}
(18,1,1) = {"
UR
rp
rp
Rj
uI
LR
SU
uI
Mt
uI
BT
BT
BT
eY
Mt
NK
UV
Rj
KL
BT
BT
vG
RA
fM
UR
"}
(19,1,1) = {"
UR
rp
rp
Rj
hQ
Bk
Mt
uI
LD
uI
Mt
BT
BT
nK
Mt
Mt
Ii
Rj
Yt
BT
BT
vG
SB
RA
go
"}
(20,1,1) = {"
UR
rp
rp
Rj
Rj
uI
Mt
uI
Mt
uI
Mt
uI
ST
Ln
BT
BT
fX
fX
fX
Mt
BT
Ln
qe
fM
go
"}
(21,1,1) = {"
UR
rp
rp
rp
Rj
Rj
ec
Mt
Mt
Mt
jr
Rj
Ln
Ln
Rj
vU
Nz
oY
Mt
Fc
Ln
Ln
rp
rp
UR
"}
(22,1,1) = {"
UR
UR
rp
rp
rp
Rj
Rj
Oc
RG
VS
Rj
Rj
rp
rp
ct
rg
dG
Nz
gu
Rj
Ln
rp
rp
rp
UR
"}
(23,1,1) = {"
UR
UR
UR
rp
rp
rp
Rj
Rj
Rj
Rj
Rj
rp
rp
Bv
LX
Rj
Rj
Rj
Rj
Rj
rp
rp
rp
rp
UR
"}
(24,1,1) = {"
UR
UR
UR
UR
rp
rp
rp
rp
rp
rp
rp
rp
fM
fM
rp
rp
rp
fM
rp
rp
rp
rp
UR
UR
UR
"}
(25,1,1) = {"
UR
UR
UR
UR
UR
UR
UR
UR
UR
UR
UR
UR
UR
UR
UR
UR
UR
UR
UR
UR
UR
UR
UR
UR
UR
"}
