"at" = (/obj/structure/bed/chair/sofa/black/right{dir = 1},/turf/simulated/floor/wood,/area/submap/abandonedhome)
"au" = (/obj/item/organ/internal/lungs/vox,/obj/item/weapon/beartrap/hunting{anchored = 1; deployed = 1},/obj/structure/curtain/black,/obj/random/junk,/obj/random/junk,/obj/random/junk,/turf/simulated/floor,/area/submap/abandonedhome)
"aw" = (/obj/structure/flora/tree/sif,/turf/template_noop,/area/submap/abandonedhome)
"aI" = (/obj/structure/window/reinforced{dir = 8; health = 1e+006},/obj/structure/flora/pottedplant/fern{pixel_y = 12},/obj/structure/table/bench/wooden,/obj/effect/decal/cleanable/dirt,/turf/simulated/floor/wood,/area/submap/abandonedhome)
"aK" = (/obj/effect/decal/cleanable/dirt,/turf/simulated/floor,/area/submap/abandonedhome)
"bb" = (/obj/effect/decal/cleanable/dirt,/obj/effect/decal/cleanable/dirt,/turf/simulated/floor/wood/broken,/area/submap/abandonedhome)
"ck" = (/obj/machinery/light/small{dir = 8},/obj/effect/decal/cleanable/dirt,/turf/simulated/floor/wood,/area/submap/abandonedhome)
"cn" = (/obj/machinery/light{dir = 8},/obj/item/weapon/paper/courtroom,/obj/item/weapon/paper/courtroom,/obj/item/weapon/paper_bin,/obj/structure/table/wooden_reinforced,/turf/simulated/floor/wood,/area/submap/abandonedhome)
"cE" = (/obj/structure/table/marble,/obj/item/organ/internal/brain/grey,/obj/item/weapon/material/knife/plastic,/turf/simulated/floor,/area/submap/abandonedhome)
"cS" = (/obj/effect/decal/cleanable/dirt,/obj/effect/decal/cleanable/dirt,/turf/simulated/floor/wood,/area/submap/abandonedhome)
"dR" = (/obj/item/weapon/paper{info = "Seems to be filled with odd runes drawn with blood"; name = "Blood stained paper"},/turf/simulated/floor/carpet/sblucarpet,/area/submap/abandonedhome)
"ew" = (/obj/machinery/light/small{dir = 4},/obj/effect/decal/cleanable/dirt,/obj/effect/decal/cleanable/dirt,/turf/simulated/floor,/area/submap/abandonedhome)
"eL" = (/obj/machinery/button/windowtint{id = h_master},/turf/simulated/wall/wood,/area/submap/abandonedhome)
"fl" = (/obj/structure/loot_pile/maint/trash,/turf/template_noop,/area/submap/abandonedhome)
"gn" = (/obj/structure/window/reinforced{dir = 4; health = 1e+006},/turf/template_noop,/area/submap/abandonedhome)
"gI" = (/obj/structure/table/rack,/obj/item/weapon/material/knife/ritual,/obj/structure/curtain/open/bed,/obj/item/clothing/under/suit_jacket/really_black,/obj/item/clothing/under/suit_jacket/navy,/obj/item/clothing/head/soft/solgov/veteranhat,/turf/simulated/floor/wood,/area/submap/abandonedhome)
"hh" = (/obj/item/weapon/reagent_containers/food/condiment/small/peppermill,/obj/item/weapon/pen,/turf/simulated/floor/wood,/area/submap/abandonedhome)
"hq" = (/obj/structure/table/bench/marble,/obj/structure/window/reinforced/polarized{id = h_master},/obj/structure/flora/pottedplant/dead{pixel_y = 7},/turf/simulated/floor/wood,/area/submap/abandonedhome)
"hH" = (/obj/structure/table/marble,/obj/item/weapon/material/sharpeningkit,/obj/item/weapon/reagent_containers/dropper,/turf/simulated/floor/tiled/white,/area/submap/abandonedhome)
"hK" = (/obj/structure/bed/chair/wood{dir = 1},/obj/structure/window/reinforced/polarized{dir = 4; id = h_kitchen},/turf/simulated/floor/wood,/area/submap/abandonedhome)
"ii" = (/obj/random/junk,/obj/effect/decal/cleanable/dirt,/turf/simulated/floor/wood,/area/submap/abandonedhome)
"ip" = (/obj/item/weapon/pen,/turf/simulated/floor/wood,/area/submap/abandonedhome)
"iw" = (/turf/simulated/floor/wood/broken,/area/submap/abandonedhome)
"iQ" = (/obj/structure/table/marble,/obj/item/weapon/material/knife/butch,/obj/item/weapon/material/kitchen/rollingpin,/turf/simulated/floor/tiled/white,/area/submap/abandonedhome)
"jt" = (/obj/structure/fence/corner{dir = 8},/turf/simulated/floor/outdoors/grass/heavy,/area/submap/abandonedhome)
"jy" = (/obj/item/weapon/material/shard,/obj/item/weapon/material/shard{pixel_x = 5; pixel_y = 10},/obj/effect/decal/cleanable/dirt,/obj/effect/decal/cleanable/dirt,/turf/simulated/floor/wood,/area/submap/abandonedhome)
"jH" = (/obj/item/weapon/material/kitchen/utensil/spoon{pixel_x = 2},/turf/simulated/floor/wood,/area/submap/abandonedhome)
"jK" = (/obj/structure/bed/chair/wood,/turf/simulated/floor/wood,/area/submap/abandonedhome)
"kg" = (/obj/structure/table/marble,/obj/item/weapon/material/kitchen/utensil/spoon,/turf/simulated/floor/tiled/white,/area/submap/abandonedhome)
"kn" = (/obj/structure/bed/chair/wood,/obj/structure/window/reinforced/polarized{dir = 4; id = h_kitchen},/turf/simulated/floor/wood,/area/submap/abandonedhome)
"ks" = (/obj/item/weapon/photo,/obj/item/weapon/photo{pixel_x = 4},/obj/structure/table/bench/wooden,/turf/simulated/floor/wood,/area/submap/abandonedhome)
"kT" = (/obj/machinery/light/small{dir = 1},/obj/structure/bed/padded,/obj/item/weapon/book/custom_library/fiction/truelovehathmyheart,/obj/item/weapon/bedsheet/clown,/turf/simulated/floor/wood,/area/submap/abandonedhome)
"kU" = (/obj/item/weapon/chainsaw,/obj/item/weapon/storage/box/lights/mixed,/obj/item/weapon/extinguisher,/obj/item/weapon/storage/toolbox/mechanical,/obj/structure/table/rack,/turf/simulated/floor,/area/submap/abandonedhome)
"ld" = (/obj/machinery/power/port_gen/pacman,/obj/effect/decal/cleanable/dirt,/turf/simulated/floor,/area/submap/abandonedhome)
"lz" = (/obj/item/weapon/reagent_containers/glass/rag,/obj/item/clothing/gloves/ring/engagement,/obj/structure/table/wooden_reinforced,/turf/simulated/floor/wood,/area/submap/abandonedhome)
"lB" = (/obj/structure/window/reinforced/polarized{dir = 4; id = h_kitchen},/obj/item/trash/plate,/obj/structure/table/sifwooden_reinforced,/turf/simulated/floor/wood,/area/submap/abandonedhome)
"lJ" = (/obj/item/device/tape,/obj/structure/table/wooden_reinforced,/turf/simulated/floor/wood,/area/submap/abandonedhome)
"lS" = (/obj/item/organ/internal/liver,/obj/random/trash,/turf/simulated/floor,/area/submap/abandonedhome)
"ma" = (/turf/simulated/wall/wood,/area/submap/abandonedhome)
"mn" = (/obj/item/clothing/mask/muzzle,/obj/random/trash,/turf/simulated/floor,/area/submap/abandonedhome)
"na" = (/mob/living/simple_mob/animal/passive/cat/bones{desc = "A very odd behaved cat, their scratched name tag reads 'Felix'. They look very malnourished."; name = "Felix"},/obj/effect/decal/cleanable/dirt,/turf/simulated/floor/wood,/area/submap/abandonedhome)
"ni" = (/obj/effect/decal/cleanable/dirt,/obj/effect/decal/cleanable/dirt,/turf/simulated/floor,/area/submap/abandonedhome)
"nz" = (/obj/item/device/flashlight{pixel_x = 2; pixel_y = 2},/obj/effect/decal/cleanable/dirt,/obj/effect/decal/cleanable/dirt,/turf/simulated/floor,/area/submap/abandonedhome)
"nD" = (/obj/structure/bed/chair/sofa/black,/turf/simulated/floor/wood,/area/submap/abandonedhome)
"nL" = (/obj/machinery/appliance/cooker/oven,/turf/simulated/floor/tiled/white,/area/submap/abandonedhome)
"nT" = (/obj/item/stack/cable_coil,/turf/simulated/floor/wood/broken,/area/submap/abandonedhome)
"ox" = (/obj/structure/closet/cabinet,/obj/item/weapon/storage/wallet/random,/obj/item/weapon/towel/random,/obj/item/weapon/melee/umbrella/random,/obj/random/ammo,/obj/random/cigarettes,/obj/random/contraband,/obj/random/junk,/obj/random/maintenance/security,/obj/random/maintenance/medical,/obj/random/maintenance/medical,/turf/simulated/floor/wood,/area/submap/abandonedhome)
"oS" = (/obj/structure/closet/cabinet,/obj/random/tech_supply/component,/obj/random/tech_supply/component,/obj/random/tech_supply/component,/obj/random/tech_supply/component,/obj/random/tech_supply/component,/obj/random/toolbox,/obj/random/toolbox,/turf/simulated/floor/wood,/area/submap/abandonedhome)
"oZ" = (/obj/structure/bed/chair/sofa/black/left,/turf/simulated/floor/wood,/area/submap/abandonedhome)
"pb" = (/obj/structure/fence/cut/large{dir = 8},/turf/template_noop,/area/submap/abandonedhome)
"po" = (/obj/structure/sign/periodic,/turf/simulated/wall/wood,/area/submap/abandonedhome)
"pX" = (/obj/effect/decal/cleanable/dirt,/turf/simulated/floor/wood/broken,/area/submap/abandonedhome)
"qa" = (/obj/structure/fence,/turf/simulated/floor/outdoors/grass/heavy,/area/submap/abandonedhome)
"qi" = (/obj/structure/table/marble,/obj/machinery/chemical_dispenser/bar_alc/full,/turf/simulated/floor/tiled/white,/area/submap/abandonedhome)
"qk" = (/obj/structure/table/marble,/obj/machinery/light{dir = 1},/obj/machinery/microwave,/turf/simulated/floor/tiled/white,/area/submap/abandonedhome)
"qo" = (/obj/item/weapon/phone,/obj/structure/table/bench/wooden,/obj/item/weapon/paper{info = "Seems to be filled with odd runes drawn with blood"; name = "Blood stained paper"},/turf/simulated/floor/wood,/area/submap/abandonedhome)
"qE" = (/obj/effect/decal/cleanable/blood/gibs,/turf/simulated/floor,/area/submap/abandonedhome)
"qN" = (/obj/effect/decal/cleanable/dirt,/turf/simulated/floor/carpet/sblucarpet,/area/submap/abandonedhome)
"rg" = (/obj/structure/window/reinforced/polarized{dir = 8; id = h-living},/obj/structure/bed/chair/sofa/black{dir = 4},/turf/simulated/floor/wood,/area/submap/abandonedhome)
"ro" = (/obj/item/weapon/pack/cardemon,/turf/simulated/floor/carpet/bcarpet,/area/submap/abandonedhome)
"ru" = (/obj/structure/table/rack,/obj/item/weapon/makeover,/obj/structure/curtain/open/bed,/turf/simulated/floor/wood,/area/submap/abandonedhome)
"rE" = (/obj/item/weapon/material/shard,/turf/simulated/floor/outdoors/grass/heavy,/area/submap/abandonedhome)
"tp" = (/obj/structure/flora/pottedplant/bamboo{pixel_y = 12},/obj/structure/table/bench/wooden,/turf/simulated/floor/wood,/area/submap/abandonedhome)
"uc" = (/obj/structure/girder,/turf/simulated/floor,/area/submap/abandonedhome)
"uh" = (/obj/structure/fence/cut/medium{dir = 4},/turf/simulated/floor/outdoors/grass/heavy,/area/submap/abandonedhome)
"um" = (/obj/structure/window/reinforced/tinted/frosted{dir = 8},/obj/structure/table/wooden_reinforced,/obj/item/weapon/book/tome,/turf/simulated/floor/wood,/area/submap/abandonedhome)
"uo" = (/obj/item/weapon/material/shard,/turf/simulated/floor/outdoors/dirt,/area/submap/abandonedhome)
"ur" = (/obj/structure/table/marble,/obj/item/weapon/material/knife/hook,/turf/simulated/floor,/area/submap/abandonedhome)
"uw" = (/obj/item/seeds/random,/obj/item/weapon/reagent_containers/spray/cleaner,/obj/structure/table/wooden_reinforced,/turf/simulated/floor/wood,/area/submap/abandonedhome)
"uC" = (/obj/item/seeds/random,/obj/item/seeds/random,/obj/machinery/space_heater,/turf/simulated/floor/wood,/area/submap/abandonedhome)
"uI" = (/obj/machinery/portable_atmospherics/hydroponics/soil,/turf/simulated/floor/outdoors/grass/heavy,/area/submap/abandonedhome)
"uK" = (/obj/item/weapon/material/minihoe,/turf/simulated/floor/outdoors/grass/heavy,/area/submap/abandonedhome)
"uR" = (/obj/effect/decal/cleanable/dirt,/turf/simulated/floor/wood,/area/submap/abandonedhome)
"ve" = (/obj/structure/table/bench/glass,/turf/simulated/floor/carpet/sblucarpet,/area/submap/abandonedhome)
"wa" = (/turf/simulated/floor/wood,/area/submap/abandonedhome)
"wj" = (/obj/item/weapon/bedsheet/rddouble,/turf/simulated/floor/wood,/area/submap/abandonedhome)
"xr" = (/obj/effect/decal/cleanable/dirt,/turf/simulated/floor/carpet/bcarpet,/area/submap/abandonedhome)
"xM" = (/obj/structure/fence/cut/large{dir = 8},/turf/simulated/floor/outdoors/grass/heavy,/area/submap/abandonedhome)
"xO" = (/obj/item/clothing/suit/straight_jacket,/turf/simulated/floor,/area/submap/abandonedhome)
"yh" = (/turf/simulated/floor/outdoors/dirt,/area/submap/abandonedhome)
"yn" = (/obj/structure/window/reinforced/polarized{dir = 8; id = h-living},/obj/structure/bed/chair/sofa/black/corner{dir = 1},/turf/simulated/floor/wood,/area/submap/abandonedhome)
"yr" = (/obj/item/weapon/reagent_containers/blood,/obj/item/weapon/pack/cardemon,/obj/item/weapon/pack/cardemon,/obj/item/weapon/deck/tarot,/obj/structure/table/wooden_reinforced,/turf/simulated/floor/wood,/area/submap/abandonedhome)
"yt" = (/obj/effect/decal/cleanable/dirt,/obj/effect/decal/cleanable/dirt,/turf/simulated/floor/carpet/sblucarpet,/area/submap/abandonedhome)
"yF" = (/obj/structure/bed/chair/sofa/black{dir = 1},/turf/simulated/floor/wood,/area/submap/abandonedhome)
"yQ" = (/obj/effect/decal/cleanable/dirt,/turf/simulated/floor/tiled/white,/area/submap/abandonedhome)
"zN" = (/obj/item/weapon/paper{info = "Seems to be filled with odd runes drawn with blood"; name = "Blood stained paper"},/turf/simulated/floor/wood,/area/submap/abandonedhome)
"AQ" = (/obj/structure/window/reinforced{dir = 8; health = 1e+006},/obj/item/weapon/material/shard,/turf/simulated/floor/outdoors/dirt,/area/submap/abandonedhome)
"BH" = (/obj/item/weapon/paper{info = "F%$K this detective, I swear I can see them peeking from behind the window, these tinted glasses help but I swear I can still see them snooping around. His days are counted... I am so close to figuring this out, just need a few more days. Then Shepiffany will be part of the family once again, then our two kids and I can go back on having a normal life... a normal life..."; name = "Stained sheet of paper"},/obj/effect/decal/cleanable/dirt,/obj/effect/decal/cleanable/dirt,/turf/simulated/floor/carpet/sblucarpet,/area/submap/abandonedhome)
"Dd" = (/obj/structure/window/reinforced/polarized{dir = 4; id = h_kitchen},/obj/item/weapon/storage/box/donkpockets,/obj/item/weapon/storage/box/condimentbottles,/obj/item/weapon/reagent_containers/food/condiment/sugar,/obj/structure/curtain/open/bed,/obj/structure/table/rack,/turf/simulated/floor/tiled/white,/area/submap/abandonedhome)
"Dk" = (/obj/effect/decal/cleanable/dirt,/obj/effect/decal/cleanable/dirt,/turf/simulated/floor/tiled/white,/area/submap/abandonedhome)
"DE" = (/obj/structure/window/reinforced/tinted/frosted{dir = 8},/obj/item/weapon/storage/box/glasses/square{pixel_y = -2},/obj/item/weapon/storage/box/glass_extras/sticks{pixel_y = 4},/obj/item/weapon/storage/box/glass_extras/straws{pixel_y = 7},/obj/item/weapon/packageWrap,/obj/structure/curtain/open/bed,/obj/item/weapon/material/kitchen/utensil/fork,/obj/item/weapon/material/kitchen/utensil/fork,/obj/item/weapon/material/kitchen/utensil/spoon{pixel_x = 2},/obj/item/weapon/material/kitchen/utensil/spoon{pixel_x = 2},/obj/structure/table/rack,/turf/simulated/floor/tiled/white,/area/submap/abandonedhome)
"DG" = (/obj/structure/simple_door/wood,/turf/simulated/floor,/area/submap/abandonedhome)
"DL" = (/obj/structure/closet/cabinet,/obj/item/weapon/storage/wallet/random,/obj/item/weapon/towel/random,/obj/item/weapon/melee/umbrella/random,/obj/random/carp_plushie,/obj/random/curseditem,/obj/random/junk,/obj/random/maintenance/medical,/obj/random/maintenance/medical,/obj/random/maintenance/medical,/turf/simulated/floor/wood,/area/submap/abandonedhome)
"Ea" = (/obj/item/weapon/pack/cardemon,/turf/simulated/floor/wood,/area/submap/abandonedhome)
"Ek" = (/obj/structure/window/reinforced{dir = 4; health = 1e+006},/turf/simulated/floor/outdoors/dirt,/area/submap/abandonedhome)
"Eo" = (/obj/random/junk,/turf/simulated/floor/carpet/sblucarpet,/area/submap/abandonedhome)
"Ex" = (/obj/item/weapon/paper{info = "Seems to be filled with odd runes drawn with blood"; name = "Blood stained paper"},/obj/effect/decal/cleanable/dirt,/obj/effect/decal/cleanable/dirt,/turf/simulated/floor/wood/broken,/area/submap/abandonedhome)
"EZ" = (/obj/effect/decal/cleanable/blood/gibs,/obj/structure/table/marble,/obj/item/organ/internal/intestine/unathi,/obj/item/weapon/surgical/bonesetter,/obj/item/weapon/bone/ribs,/obj/item/weapon/bone/skull{pixel_x = 4; pixel_y = 6},/turf/simulated/floor,/area/submap/abandonedhome)
"Fh" = (/obj/structure/coatrack,/obj/effect/decal/cleanable/dirt,/turf/simulated/floor/wood,/area/submap/abandonedhome)
"Fu" = (/turf/simulated/floor/carpet/sblucarpet,/area/submap/abandonedhome)
"Fy" = (/obj/structure/window/reinforced{dir = 1},/obj/machinery/portable_atmospherics/hydroponics/soil,/turf/simulated/floor/outdoors/grass/heavy,/area/submap/abandonedhome)
"FN" = (/obj/machinery/button/windowtint{id = h-living},/turf/simulated/wall/wood,/area/submap/abandonedhome)
"Gm" = (/obj/machinery/button/windowtint{id = h_kitchen},/turf/simulated/wall/wood,/area/submap/abandonedhome)
"Gr" = (/obj/structure/table/bench/marble,/obj/structure/window/reinforced/polarized{id = h_master},/obj/structure/flora/pottedplant/bamboo{pixel_y = 7},/turf/simulated/floor/wood,/area/submap/abandonedhome)
"GA" = (/obj/item/weapon/reagent_containers/food/snacks/ghostmuffin/poison,/obj/structure/table/sifwooden_reinforced,/turf/simulated/floor/wood,/area/submap/abandonedhome)
"GS" = (/obj/structure/table/steel,/obj/item/stack/material/phoron{amount = 5},/obj/item/stack/material/phoron{amount = 5},/obj/fiftyspawner/wood,/obj/fiftyspawner/steel,/turf/simulated/floor,/area/submap/abandonedhome)
"Hc" = (/obj/effect/decal/cleanable/blood/gibs,/obj/structure/kitchenspike,/obj/effect/rune,/turf/simulated/floor,/area/submap/abandonedhome)
"Hu" = (/obj/item/frame/apc,/obj/machinery/light_switch{pixel_x = 11; pixel_y = 22},/obj/random/junk,/turf/simulated/floor,/area/submap/abandonedhome)
"Im" = (/obj/structure/window/reinforced/tinted/frosted{dir = 8},/turf/simulated/floor/wood,/area/submap/abandonedhome)
"Ji" = (/obj/structure/fence/cut/medium,/turf/simulated/floor/outdoors/grass/heavy,/area/submap/abandonedhome)
"Jq" = (/obj/structure/bed/double/padded,/obj/machinery/light/small{dir = 4},/turf/simulated/floor/wood,/area/submap/abandonedhome)
"JW" = (/obj/structure/simple_door/wood,/turf/simulated/floor/wood,/area/submap/abandonedhome)
"Kb" = (/obj/structure/loot_pile/maint/trash,/turf/simulated/floor/outdoors/grass/heavy,/area/submap/abandonedhome)
"Ki" = (/obj/structure/closet/cabinet,/obj/random/multiple,/obj/random/multiple,/obj/random/multiple,/obj/random/multiple,/obj/random/multiple,/obj/random/toy,/obj/random/toy,/obj/item/weapon/storage/mre/random,/obj/item/weapon/storage/mre/random,/turf/simulated/floor/wood,/area/submap/abandonedhome)
"Kr" = (/obj/machinery/portable_atmospherics/hydroponics/soil,/obj/item/weapon/material/shard,/turf/simulated/floor/outdoors/grass/heavy,/area/submap/abandonedhome)
"Kw" = (/obj/structure/closet/secure_closet/freezer/fridge,/obj/random/meat,/obj/random/meat,/obj/random/meat,/obj/random/meat,/obj/random/meat,/turf/simulated/floor/tiled/white,/area/submap/abandonedhome)
"Ll" = (/obj/machinery/space_heater,/turf/simulated/floor/wood,/area/submap/abandonedhome)
"LS" = (/obj/item/trash/plate,/obj/item/weapon/reagent_containers/food/condiment/small/saltshaker,/obj/structure/table/sifwooden_reinforced,/turf/simulated/floor/wood,/area/submap/abandonedhome)
"Mb" = (/obj/structure/bed/chair/wood{dir = 1},/turf/simulated/floor/wood,/area/submap/abandonedhome)
"Mn" = (/obj/structure/window/reinforced/polarized{dir = 4; id = h_kitchen},/obj/item/weapon/reagent_containers/food/condiment/enzyme,/turf/simulated/floor/tiled/white,/area/submap/abandonedhome)
"MM" = (/turf/simulated/floor/outdoors/grass/heavy,/area/submap/abandonedhome)
"Nx" = (/obj/machinery/light{dir = 4},/turf/simulated/floor/wood,/area/submap/abandonedhome)
"ND" = (/obj/structure/table/bench/marble,/obj/structure/window/reinforced/polarized{dir = 8; id = h-living},/turf/simulated/floor/wood,/area/submap/abandonedhome)
"NK" = (/obj/random/trash,/obj/effect/decal/cleanable/dirt,/obj/effect/decal/cleanable/dirt,/turf/simulated/floor/carpet/sblucarpet,/area/submap/abandonedhome)
"NL" = (/turf/template_noop,/area/submap/abandonedhome)
"Od" = (/obj/item/weapon/extinguisher{pixel_x = 8; pixel_y = 1},/obj/random/maintenance/medical,/obj/random/maintenance/medical,/obj/random/maintenance/medical,/obj/random/medical/lite,/obj/random/medical/lite,/obj/structure/mopbucket{pixel_x = -8; pixel_y = -4},/obj/item/weapon/mop,/obj/item/device/multitool,/obj/item/device/flashlight{pixel_x = 2; pixel_y = 2},/obj/random/unidentified_medicine,/obj/random/unidentified_medicine,/obj/random/unidentified_medicine,/obj/structure/table/steel,/turf/simulated/floor/tiled,/area/submap/abandonedhome)
"Oe" = (/obj/structure/window/reinforced{dir = 8; health = 1e+006},/turf/template_noop,/area/submap/abandonedhome)
"Or" = (/obj/structure/table/bench/marble,/obj/structure/window/reinforced/polarized{id = h_master},/obj/structure/flora/pottedplant/overgrown{pixel_y = 7},/turf/simulated/floor/wood,/area/submap/abandonedhome)
"OL" = (/obj/structure/window/reinforced/polarized{dir = 4; id = h_kitchen},/obj/item/weapon/material/kitchen/utensil/spoon{pixel_x = 2},/obj/structure/table/sifwooden_reinforced,/turf/simulated/floor/wood,/area/submap/abandonedhome)
"Pc" = (/obj/item/weapon/material/kitchen/utensil/fork,/obj/random/trash,/turf/simulated/floor/wood,/area/submap/abandonedhome)
"Qx" = (/obj/item/weapon/material/shard{pixel_x = 6},/obj/item/weapon/material/shard,/turf/simulated/floor/outdoors/dirt,/area/submap/abandonedhome)
"QU" = (/obj/effect/decal/cleanable/blood/gibs,/obj/item/clothing/gloves/yellow,/turf/simulated/floor,/area/submap/abandonedhome)
"QX" = (/obj/random/trash,/turf/simulated/floor/wood,/area/submap/abandonedhome)
"RI" = (/obj/structure/window/reinforced{dir = 8; health = 1e+006},/turf/simulated/floor/outdoors/dirt,/area/submap/abandonedhome)
"Sd" = (/obj/structure/fence/corner,/turf/template_noop,/area/submap/abandonedhome)
"Sp" = (/obj/item/weapon/material/shard,/obj/item/weapon/material/shard{pixel_x = 5; pixel_y = 3},/turf/simulated/floor/outdoors/dirt,/area/submap/abandonedhome)
"SN" = (/obj/structure/bed/chair/wood/wings{dir = 1},/obj/effect/gibspawner/human,/turf/simulated/floor/carpet/sblucarpet,/area/submap/abandonedhome)
"Tg" = (/obj/item/weapon/material/kitchen/utensil/fork,/obj/effect/decal/cleanable/dirt,/turf/simulated/floor/wood,/area/submap/abandonedhome)
"Tw" = (/obj/item/weapon/cell/high/empty,/turf/simulated/floor/carpet/sblucarpet,/area/submap/abandonedhome)
"TX" = (/obj/item/clothing/suit/storage/apron/white,/obj/effect/decal/cleanable/dirt,/turf/simulated/floor/tiled/white,/area/submap/abandonedhome)
"Uj" = (/obj/machinery/light/small,/obj/item/weapon/ore/diamond,/obj/structure/sign/goldenplaque{desc = "Done No Harm."; name = "Best Doctor 2552"; pixel_y = -32},/obj/structure/table/wooden_reinforced,/turf/simulated/floor/wood,/area/submap/abandonedhome)
"UA" = (/obj/structure/fence/door/opened,/turf/template_noop,/area/submap/abandonedhome)
"UB" = (/obj/item/weapon/storage/box/characters,/obj/structure/curtain/open/bed,/obj/structure/table/rack,/turf/simulated/floor/wood,/area/submap/abandonedhome)
"US" = (/turf/simulated/floor/tiled/white,/area/submap/abandonedhome)
"Vn" = (/obj/item/weapon/reagent_containers/food/condiment/small/sugar,/obj/effect/decal/cleanable/dirt,/turf/simulated/floor/wood/broken,/area/submap/abandonedhome)
"VI" = (/obj/structure/fence{dir = 4},/turf/template_noop,/area/submap/abandonedhome)
"Wf" = (/obj/structure/bed/padded,/obj/random/trash,/obj/random/trash,/obj/random/trash,/obj/random/trash,/obj/random/trash,/obj/random/junk,/obj/random/junk,/obj/random/junk,/obj/random/junk,/obj/item/weapon/bedsheet/ian,/turf/simulated/floor/wood,/area/submap/abandonedhome)
"Wj" = (/obj/machinery/gibber/autogibber{emagged = 1},/turf/simulated/floor,/area/submap/abandonedhome)
"Wn" = (/obj/structure/fence/cut/medium{dir = 4},/turf/template_noop,/area/submap/abandonedhome)
"WQ" = (/obj/structure/window/reinforced/polarized{dir = 8; id = h-living},/obj/structure/bed/chair/sofa/black/corner{dir = 4},/turf/simulated/floor/wood,/area/submap/abandonedhome)
"Xc" = (/obj/item/weapon/module/power_control,/obj/effect/decal/cleanable/dirt,/turf/simulated/floor/wood,/area/submap/abandonedhome)
"Xz" = (/obj/item/weapon/material/shard,/turf/template_noop,/area/submap/abandonedhome)
"Ys" = (/obj/item/weapon/pen/fountain,/turf/simulated/floor/wood,/area/submap/abandonedhome)
"YK" = (/obj/structure/table/marble,/obj/item/organ/internal/intestine/unathi{pixel_x = -1; pixel_y = 8},/obj/item/organ/internal/lungs,/turf/simulated/floor,/area/submap/abandonedhome)
"Zi" = (/obj/machinery/light{dir = 8},/turf/simulated/floor/wood,/area/submap/abandonedhome)
"ZR" = (/obj/structure/fence{dir = 4},/turf/simulated/floor/outdoors/grass/heavy,/area/submap/abandonedhome)

(1,1,1) = {"
NLNLNLNLNLyhNLyhNLNLNLNLNLNLNLNLNLNLNLNL
NLNLNLNLyhyhyhNLNLNLNLNLNLNLNLNLNLawNLNL
NLNLNLNLyhNLNLNLawNLNLNLNLNLNLNLNLNLNLNL
NLNLyhmayhmaNLNLNLNLNLNLNLNLNLNLNLNLNLNL
NLNLmamaJWmamaflNLflmamaucucmamaNLNLNLNL
NLmaFNFhpXLlucmamamamaKwnLqkqimamamayhNL
yhNLNDuRcSiwwalJmaOdmayQDkTXDkDEDdyhNLNL
NLgnynnDoZpXiwQXucJWmaiQkghHyQUSMnAQNLNL
XzSprgveFuFuEowaJWcSJWwauRiiTgjKknQxuoNL
NLEkrgveFuqNqNNxmacSmaZinTiwiwLSOLRINLNL
XzEkWQyFatwacSXctpjyaIuRuRVnPcGAlBXzNLNL
NLucmamamamaucmamabbucipjHwahhMbhKOeyhNL
NLmamarugIumuRExJWpXmauCuwUjlzGmmamaNLNL
NLmaDLzNTwSNBHbbmackmamaucmamamaHcmamaNL
NLmacnYsdRNKytksuccSmaUBImkTKimaxOWjmaNL
NLmaoxnaNKFuqNJqmacSJWpXxrroyrmalSEZmaNL
NLmapoLliwwawjqomauRmaLlEaWfoSmamncEmaNL
NLflmamaOrGrhqeLmaiwmaaKmamamamaQUurmaNL
MMNLmaKrFyKruIFymaJWmaldHuGSkUmaqEYKmaNL
NLMMqaMMMMrEMMMMuKMMDGnininzewucaumamaNL
NLMMJiMMMMMMMMMMMMKbmamamaucmamaucmaNLNL
NLNLqaMMMMMMMMMMMMMMMMMMMMMMMMMMMMqaNLNL
NLMMjtVIpbuhZRZRpbUAVIpbVIWnVIVIxMSdNLNL
MMMMNLNLNLNLNLNLNLNLNLNLNLNLNLNLNLMMNLNL
NLNLNLNLNLNLNLNLNLNLawNLNLNLNLNLNLNLNLNL
"}
