"a" = (/turf/template_noop,/area/template_noop)
"b" = (/turf/simulated/floor/outdoors/snow/sif/planetuse,/area/submap/RationCache)
"c" = (/mob/living/simple_animal/retaliate/diyaab{returns_home = 1},/turf/simulated/floor/outdoors/snow/sif/planetuse,/area/submap/RationCache)
"d" = (/mob/living/simple_animal/retaliate/diyaab{returns_home = 1},/turf/simulated/floor/outdoors/dirt/sif/planetuse,/area/submap/RationCache)
"e" = (/turf/simulated/floor/outdoors/dirt/sif/planetuse,/area/submap/RationCache)
"f" = (/obj/item/trash/liquidfood,/obj/item/trash/liquidfood,/obj/item/trash/liquidfood,/obj/item/trash/liquidfood,/obj/item/trash/liquidfood,/obj/item/trash/liquidfood,/turf/simulated/mineral/floor/ignore_mapgen/sif{sand_dug = 1},/area/submap/RationCache)
"g" = (/obj/machinery/portable_atmospherics/hydroponics/soil,/turf/simulated/floor/outdoors/dirt/sif/planetuse,/area/submap/RationCache)

(1,1,1) = {"
aaaabbbaaa
aabbbbbbaa
abbbbcbbbb
abbbdbbcbb
bbcefebbbb
bbbegebbbb
bbbbebcbbb
bbbbbbbbaa
aabbcbbaaa
aabbbaaaaa
"}
