"aa" = (/turf/simulated/mineral/floor/ignore_mapgen,/area/submap/CrashedMedShuttle)
"ab" = (/turf/simulated/floor/outdoors/rocks,/area/submap/CrashedMedShuttle)
"ac" = (/obj/structure/lattice,/turf/simulated/floor/outdoors/rocks,/area/submap/CrashedMedShuttle)
"ad" = (/obj/effect/spider/stickyweb,/turf/simulated/shuttle/plating,/area/submap/CrashedMedShuttle)
"ae" = (/obj/structure/sign/greencross{desc = "White cross in a green field, you can get medical aid here."; name = "First-Aid"},/turf/simulated/shuttle/wall/no_join,/area/submap/CrashedMedShuttle)
"af" = (/obj/structure/grille,/obj/structure/shuttle/window,/turf/simulated/shuttle/plating,/area/submap/CrashedMedShuttle)
"ag" = (/turf/simulated/shuttle/wall,/area/submap/CrashedMedShuttle)
"ah" = (/obj/item/weapon/material/shard{icon_state = "medium"},/turf/simulated/mineral/floor/ignore_mapgen,/area/submap/CrashedMedShuttle)
"ai" = (/obj/item/weapon/material/shard{icon_state = "medium"},/obj/effect/decal/cleanable/blood/oil,/obj/structure/lattice,/turf/simulated/floor/outdoors/rocks,/area/submap/CrashedMedShuttle)
"aj" = (/obj/machinery/light/small{dir = 4; pixel_y = 0},/obj/structure/sign/warning/airlock{pixel_x = 32},/obj/effect/spider/stickyweb,/turf/simulated/shuttle/plating,/area/submap/CrashedMedShuttle)
"ak" = (/obj/structure/table/standard,/obj/item/weapon/reagent_containers/hypospray/autoinjector/biginjector/bonemed,/obj/random/medical,/turf/simulated/shuttle/floor/white,/area/submap/CrashedMedShuttle)
"al" = (/obj/item/weapon/storage/toolbox/mechanical,/obj/machinery/light{dir = 1},/obj/structure/table/standard,/turf/simulated/shuttle/floor/white,/area/submap/CrashedMedShuttle)
"am" = (/obj/structure/table/standard,/obj/machinery/recharger{pixel_y = 4},/turf/simulated/shuttle/floor/white,/area/submap/CrashedMedShuttle)
"an" = (/obj/structure/window/reinforced,/obj/effect/decal/cleanable/blood/oil,/obj/structure/loot_pile/surface/bones,/obj/structure/lattice,/turf/simulated/floor/outdoors/rocks,/area/submap/CrashedMedShuttle)
"ao" = (/obj/item/weapon/circuitboard/broken,/obj/structure/door_assembly/door_assembly_ext,/turf/simulated/shuttle/plating,/area/submap/CrashedMedShuttle)
"ap" = (/obj/structure/door_assembly/door_assembly_ext,/turf/simulated/shuttle/plating,/area/submap/CrashedMedShuttle)
"aq" = (/obj/effect/decal/cleanable/liquid_fuel,/mob/living/simple_animal/hostile/giant_spider/webslinger{returns_home = 1},/turf/simulated/shuttle/floor/white,/area/submap/CrashedMedShuttle)
"ar" = (/obj/effect/spider/stickyweb,/turf/simulated/shuttle/floor/white,/area/submap/CrashedMedShuttle)
"as" = (/turf/simulated/shuttle/floor/white,/area/submap/CrashedMedShuttle)
"at" = (/obj/structure/closet/crate/medical,/obj/random/medical,/obj/random/medical,/turf/simulated/shuttle/floor/white,/area/submap/CrashedMedShuttle)
"au" = (/obj/structure/table/standard,/obj/machinery/cell_charger,/turf/simulated/shuttle/floor/white,/area/submap/CrashedMedShuttle)
"av" = (/obj/item/weapon/material/shard,/obj/structure/lattice,/turf/simulated/floor/outdoors/rocks,/area/submap/CrashedMedShuttle)
"aw" = (/obj/structure/closet/secure_closet/personal/patient,/obj/effect/spider/stickyweb,/turf/simulated/shuttle/floor/white,/area/submap/CrashedMedShuttle)
"ax" = (/obj/machinery/light{dir = 8; icon_state = "tube1"; pixel_y = 0},/mob/living/simple_animal/hostile/giant_spider/nurse/medical{returns_home = 1},/turf/simulated/shuttle/floor/white,/area/submap/CrashedMedShuttle)
"ay" = (/obj/machinery/door/airlock/glass,/turf/simulated/shuttle/floor/white,/area/submap/CrashedMedShuttle)
"az" = (/obj/effect/decal/cleanable/blood/drip,/obj/effect/decal/cleanable/liquid_fuel,/turf/simulated/shuttle/floor/white,/area/submap/CrashedMedShuttle)
"aA" = (/obj/effect/decal/cleanable/blood,/obj/effect/decal/cleanable/liquid_fuel,/turf/simulated/shuttle/floor/white,/area/submap/CrashedMedShuttle)
"aB" = (/mob/living/simple_animal/hostile/giant_spider/nurse/medical{returns_home = 1},/turf/simulated/shuttle/floor/white,/area/submap/CrashedMedShuttle)
"aC" = (/obj/effect/decal/cleanable/blood/gibs/robot,/obj/item/weapon/firstaid_arm_assembly,/mob/living/simple_animal/hostile/giant_spider/frost{returns_home = 1},/turf/simulated/shuttle/floor/white,/area/submap/CrashedMedShuttle)
"aD" = (/obj/machinery/suit_cycler/medical{locked = 0},/turf/simulated/shuttle/floor/white,/area/submap/CrashedMedShuttle)
"aE" = (/obj/item/stack/rods,/turf/simulated/mineral/floor/ignore_mapgen,/area/submap/CrashedMedShuttle)
"aF" = (/obj/structure/lattice,/obj/item/stack/rods,/mob/living/simple_animal/hostile/giant_spider/nurse{returns_home = 1},/turf/simulated/floor/outdoors/rocks,/area/submap/CrashedMedShuttle)
"aG" = (/obj/effect/decal/cleanable/blood/oil,/obj/item/weapon/firstaid_arm_assembly,/turf/simulated/shuttle/floor/white,/area/submap/CrashedMedShuttle)
"aH" = (/obj/structure/closet/secure_closet/personal/patient,/turf/simulated/shuttle/floor/white,/area/submap/CrashedMedShuttle)
"aI" = (/obj/effect/decal/cleanable/blood/drip,/turf/simulated/shuttle/floor/white,/area/submap/CrashedMedShuttle)
"aJ" = (/obj/structure/reagent_dispensers/fueltank,/obj/effect/decal/cleanable/liquid_fuel,/turf/simulated/shuttle/floor/white,/area/submap/CrashedMedShuttle)
"aK" = (/obj/structure/reagent_dispensers/watertank,/obj/effect/decal/cleanable/liquid_fuel,/turf/simulated/shuttle/floor/white,/area/submap/CrashedMedShuttle)
"aL" = (/obj/machinery/recharge_station,/obj/effect/decal/cleanable/liquid_fuel,/turf/simulated/shuttle/floor/white,/area/submap/CrashedMedShuttle)
"aM" = (/obj/structure/table/standard,/obj/item/clothing/suit/space/void/medical/alt,/obj/item/clothing/head/helmet/space/void/medical/alt,/obj/effect/spider/stickyweb,/obj/machinery/light,/turf/simulated/shuttle/floor/white,/area/submap/CrashedMedShuttle)
"aN" = (/obj/structure/table/standard,/obj/item/clothing/suit/space/void/medical/alt,/obj/item/clothing/head/helmet/space/void/medical/alt,/obj/effect/spider/stickyweb,/turf/simulated/shuttle/floor/white,/area/submap/CrashedMedShuttle)
"aO" = (/obj/structure/dispenser/oxygen,/obj/effect/spider/stickyweb,/turf/simulated/shuttle/floor/white,/area/submap/CrashedMedShuttle)
"aP" = (/obj/structure/grille/broken,/obj/item/weapon/material/shard{icon_state = "medium"},/obj/item/stack/rods,/turf/simulated/shuttle/plating,/area/submap/CrashedMedShuttle)
"aQ" = (/obj/item/weapon/material/shard,/turf/simulated/floor/outdoors/rocks,/area/submap/CrashedMedShuttle)
"aR" = (/obj/effect/decal/cleanable/blood/oil,/turf/simulated/floor/outdoors/rocks,/area/submap/CrashedMedShuttle)
"aS" = (/obj/item/weapon/material/shard{icon_state = "medium"},/obj/effect/spider/stickyweb,/turf/simulated/shuttle/floor/white,/area/submap/CrashedMedShuttle)
"aT" = (/obj/effect/decal/cleanable/blood/gibs/robot,/mob/living/simple_animal/hostile/giant_spider/nurse/medical{returns_home = 1},/turf/simulated/shuttle/floor/white,/area/submap/CrashedMedShuttle)
"aU" = (/turf/simulated/shuttle/wall/no_join,/area/submap/CrashedMedShuttle)
"aV" = (/obj/effect/decal/cleanable/blood/oil,/obj/structure/loot_pile/surface/bones,/obj/structure/lattice,/turf/simulated/floor/outdoors/rocks,/area/submap/CrashedMedShuttle)
"aW" = (/obj/machinery/light,/obj/structure/table/standard,/obj/machinery/computer/med_data/laptop,/obj/effect/spider/stickyweb,/turf/simulated/shuttle/floor/white,/area/submap/CrashedMedShuttle)
"aX" = (/obj/structure/table/standard,/obj/item/weapon/material/shard{icon_state = "medium"},/obj/random/medical,/turf/simulated/shuttle/floor/white,/area/submap/CrashedMedShuttle)
"aY" = (/obj/effect/decal/cleanable/blood/drip,/obj/structure/lattice,/turf/simulated/floor/outdoors/rocks,/area/submap/CrashedMedShuttle)
"aZ" = (/obj/machinery/blackbox_recorder,/obj/structure/closet/walllocker/emerglocker/north,/obj/item/weapon/paper/crumpled/bloody{info = "<I>\[The paper is torn at the top, presumably from the impact. It's oil-stained, but you can just about read it.]</I><BR> <B>mmons 19:52:01:</B> Come on... it's right there in the distance, we're almost there!<BR> <B>Doctor Nazarril 19:52:26:</B> Odysseus online. Orrderrs, sirr?<BR> <B>Captain Simmons 19:52:29:</B> Brace for impact. We're going in full-speed.<BR> <B>Technician Dynasty 19:52:44:</B> Chief, fire's spread to the secondary propulsion systems.<BR> <B>Captain Simmons 19:52:51:</B> Copy. Any word from TraCon? Transponder's down still?<BR> <B>Technician Dynasty 19:53:02:</B> Can't get in touch, sir. Emergency beacon's active, but we're not going t-<BR> <B>Doctor Nazarril 19:53:08:</B> Don't say it. As long as we believe, we'll get through this.<BR> <B>Captain Simmons 19:53:11:</B> Damn right. We're a few klicks out from the port. Rough landing, but we can do it.<BR> <B>V.I.T.A 19:53:26:</B> Vessel diagnostics complete. Engines one, two, three offline. Engine four status: critical. Transponder offline. Fire alarm in the patient bay.<BR> <B>A loud explosion is heard.</B><BR> <B>V.I.T.A 19:53:29:</B> Alert: fuel intake valve open.<BR> <B>Technician Dynasty 19:53:31:</B> ... ah.<BR> <B>Doctor Nazarril 19:53:34:</B> Trrranslate?<BR> <B>V.I.T.A 19:53:37:</B> There is a 16.92% chance of this vessel safely landing at the emergency destination. Note that there is an 83.08% chance of detonation of fuel supplies upon landing.<BR> <B>Technician Dynasty 19:53:48:</B> We'll make it, sure, but we'll explode and take out half the LZ with us. Propulsion's down, we can't slow down. If we land there, everyone in that port dies, no question.<BR> <B>V.I.T.A 19:53:53:</B> The Technician is correct.<BR> <B>Doctor Nazarril 19:54:02:</B> Then... we can't land therrre.<BR> <B>V.I.T.A 19:54:11:</B>  Analysing... recommended course of action: attempt emergency landing in isolated area. Chances of survival: negligible. <BR> <B>Captain Simmons 19:54:27:</B> I- alright. I'm bringing us down. You all know what this means.<BR> <B>Doctor Nazarril 19:54:33:</B> Sh... I- I understand. It's been- it's been an honorr, Captain, Dynasty, VITA.<BR> <B>Technician Dynasty 19:54:39:</B> We had a good run. I'm going to miss this.<BR> <B>Captain Simmons 19:54:47:</B> VITA. Tell them we died heroes. Tell them... we did all we could.<BR> <B>V.I.T.A 19:54:48:</B> I will. Impact in five. Four. Three.<BR> <B>Doctor Nazarril 19:54:49:</B> Oh, starrs... I- you werrre all the... best frriends she everr had. Thank you.<BR> <B>Technician Dynasty 19:54:50:</B> Any time, kid. Any time.<BR> <B>V.I.T.A 19:54:41:</B> Two.<BR> <B>V.I.T.A 19:54:42:</B> One.<BR> **8/12/2561**<BR> <B>V.I.T.A 06:22:16:</B> Backup power restored. Attempting to establish connection with emergency rescue personnel.<BR> <B>V.I.T.A 06:22:17:</B> Unable to establish connection. Transponder destroyed on impact.<BR> **16/2/2562**<BR> <B>V.I.T.A 22:19:06:</B> Power reserves critical. Transferring remaining power to emergency broadcasting beacon.<BR> <B>V.I.T.A 22:19:07:</B> Unit V.I.T.A shutting down."; name = "Blackbox Transcript: VMV Aurora's Light"},/turf/simulated/shuttle/floor/yellow,/area/submap/CrashedMedShuttle)
"ba" = (/obj/machinery/computer/crew,/turf/simulated/shuttle/floor/yellow,/area/submap/CrashedMedShuttle)
"bb" = (/obj/effect/spider/stickyweb,/turf/simulated/mineral/floor/ignore_mapgen,/area/submap/CrashedMedShuttle)
"bc" = (/obj/effect/spider/cocoon,/turf/simulated/mineral/floor/ignore_mapgen,/area/submap/CrashedMedShuttle)
"bd" = (/obj/item/weapon/material/shard{icon_state = "medium"},/turf/simulated/floor/outdoors/rocks,/area/submap/CrashedMedShuttle)
"be" = (/obj/item/stack/rods,/turf/simulated/floor/outdoors/rocks,/area/submap/CrashedMedShuttle)
"bf" = (/obj/effect/spider/stickyweb,/obj/structure/girder/displaced,/obj/structure/lattice,/turf/simulated/floor/outdoors/rocks,/area/submap/CrashedMedShuttle)
"bg" = (/obj/machinery/light{dir = 8; icon_state = "tube1"; pixel_y = 0},/obj/structure/extinguisher_cabinet{pixel_x = -32},/obj/structure/lattice,/obj/item/device/gps/internal/poi,/turf/simulated/floor/outdoors/rocks,/area/submap/CrashedMedShuttle)
"bh" = (/obj/structure/flora/tree/sif,/turf/simulated/floor/outdoors/rocks,/area/submap/CrashedMedShuttle)
"bi" = (/obj/structure/bed/chair/comfy/black{dir = 4},/mob/living/simple_animal/hostile/giant_spider/nurse/medical,/turf/simulated/floor/outdoors/rocks,/area/submap/CrashedMedShuttle)
"bj" = (/obj/effect/decal/cleanable/blood/splatter,/obj/structure/loot_pile/surface/bones,/obj/effect/decal/cleanable/blood/drip,/obj/structure/lattice,/turf/simulated/floor/outdoors/rocks,/area/submap/CrashedMedShuttle)
"bk" = (/obj/structure/grille/broken,/obj/item/weapon/material/shard{icon_state = "medium"},/turf/simulated/floor/outdoors/rocks,/area/submap/CrashedMedShuttle)
"bl" = (/obj/structure/flora/tree/sif,/obj/effect/spider/stickyweb,/turf/simulated/mineral/floor/ignore_mapgen,/area/submap/CrashedMedShuttle)
"bm" = (/obj/effect/spider/stickyweb,/mob/living/simple_animal/hostile/giant_spider/nurse/medical,/turf/simulated/floor/outdoors/rocks,/area/submap/CrashedMedShuttle)
"bn" = (/obj/effect/decal/mecha_wreckage/odysseus,/obj/effect/decal/cleanable/blood/oil,/turf/simulated/mineral/floor/ignore_mapgen,/area/submap/CrashedMedShuttle)
"bo" = (/obj/effect/spider/stickyweb,/turf/simulated/floor/outdoors/rocks,/area/submap/CrashedMedShuttle)
"bp" = (/obj/item/weapon/material/shard,/obj/effect/spider/stickyweb,/turf/simulated/floor/outdoors/rocks,/area/submap/CrashedMedShuttle)
"bq" = (/obj/effect/decal/cleanable/blood/oil,/obj/structure/lattice,/turf/simulated/floor/outdoors/rocks,/area/submap/CrashedMedShuttle)
"br" = (/obj/effect/spider/stickyweb,/obj/item/weapon/material/shard,/turf/simulated/shuttle/floor/white,/area/submap/CrashedMedShuttle)
"bs" = (/obj/effect/spider/stickyweb,/obj/random/medical,/obj/random/medical,/turf/simulated/shuttle/floor/white,/area/submap/CrashedMedShuttle)
"bt" = (/mob/living/simple_animal/hostile/giant_spider/webslinger{returns_home = 1},/turf/simulated/shuttle/floor/white,/area/submap/CrashedMedShuttle)
"bu" = (/obj/effect/spider/cocoon,/obj/structure/lattice,/turf/simulated/floor/outdoors/rocks,/area/submap/CrashedMedShuttle)
"bv" = (/obj/structure{icon = 'icons/mob/AI.dmi'; icon_state = "ai-empty"; name = "V.I.T.A"},/turf/simulated/shuttle/floor/yellow,/area/submap/CrashedMedShuttle)
"bw" = (/obj/structure/grille/broken,/obj/item/weapon/material/shard,/turf/simulated/floor/outdoors/rocks,/area/submap/CrashedMedShuttle)
"bx" = (/obj/effect/decal/cleanable/blood/drip,/obj/effect/spider/stickyweb,/mob/living/simple_animal/hostile/giant_spider/webslinger,/turf/simulated/mineral/floor/ignore_mapgen,/area/submap/CrashedMedShuttle)
"by" = (/obj/effect/decal/cleanable/blood/drip,/turf/simulated/mineral/floor/ignore_mapgen,/area/submap/CrashedMedShuttle)
"bz" = (/obj/effect/decal/remains/tajaran,/obj/item/weapon/surgical/circular_saw,/turf/simulated/floor/outdoors/rocks,/area/submap/CrashedMedShuttle)
"bA" = (/obj/effect/decal/cleanable/blood/oil,/obj/effect/spider/stickyweb,/turf/simulated/floor/outdoors/rocks,/area/submap/CrashedMedShuttle)
"bB" = (/obj/item/weapon/material/shard,/obj/structure/loot_pile/maint/technical,/obj/structure/lattice,/turf/simulated/mineral/floor/ignore_mapgen,/area/submap/CrashedMedShuttle)
"bC" = (/obj/structure/bed/chair/office/light{dir = 8},/turf/simulated/shuttle/floor/purple,/area/submap/CrashedMedShuttle)
"bD" = (/obj/item/weapon/circuitboard/broken,/turf/simulated/shuttle/floor/white,/area/submap/CrashedMedShuttle)
"bE" = (/obj/structure/girder,/turf/template_noop,/area/submap/CrashedMedShuttle)
"bF" = (/obj/structure/girder/displaced,/turf/template_noop,/area/submap/CrashedMedShuttle)
"bG" = (/obj/structure/shuttle/engine/propulsion{tag = "icon-propulsion_r (WEST)"; icon_state = "propulsion_r"; dir = 8},/turf/simulated/floor/outdoors/rocks,/area/submap/CrashedMedShuttle)
"bH" = (/obj/structure/shuttle/engine/heater{icon_state = "heater"; dir = 8},/obj/structure/window/reinforced{dir = 4},/turf/simulated/mineral/floor/ignore_mapgen,/area/submap/CrashedMedShuttle)
"bI" = (/obj/structure/table/standard,/obj/item/weapon/reagent_containers/chem_disp_cartridge/tricord{name = "unlabelled dispenser cartridge"},/obj/item/weapon/reagent_containers/chem_disp_cartridge/tramadol{name = "unlabelled dispenser cartridge"},/obj/item/weapon/reagent_containers/chem_disp_cartridge/bicaridine{name = "unlabelled dispenser cartridge"},/obj/item/weapon/reagent_containers/chem_disp_cartridge/dermaline{name = "unlabelled dispenser cartridge"},/turf/simulated/shuttle/floor/purple,/area/submap/CrashedMedShuttle)
"bJ" = (/obj/structure/table/standard,/obj/item/weapon/storage/fancy/vials,/obj/item/weapon/reagent_containers/glass/beaker/large,/turf/simulated/shuttle/floor/purple,/area/submap/CrashedMedShuttle)
"bK" = (/obj/random/medical/pillbottle,/mob/living/simple_animal/hostile/giant_spider/webslinger{returns_home = 1},/turf/simulated/shuttle/floor/white,/area/submap/CrashedMedShuttle)
"bL" = (/obj/effect/spider/stickyweb,/obj/effect/spider/stickyweb,/turf/simulated/shuttle/floor/white,/area/submap/CrashedMedShuttle)
"bM" = (/obj/structure/table/standard,/obj/item/device/defib_kit/loaded,/turf/simulated/shuttle/floor/white,/area/submap/CrashedMedShuttle)
"bN" = (/obj/structure/table/standard,/obj/random/medical,/obj/random/medical,/turf/simulated/shuttle/floor/white,/area/submap/CrashedMedShuttle)
"bO" = (/obj/structure/table/standard,/obj/item/roller,/turf/simulated/shuttle/floor/white,/area/submap/CrashedMedShuttle)
"bP" = (/obj/structure/table/standard,/obj/machinery/light{dir = 1},/obj/random/firstaid,/obj/effect/spider/stickyweb,/turf/simulated/shuttle/floor/white,/area/submap/CrashedMedShuttle)
"bQ" = (/obj/structure/table/standard,/obj/random/medical/lite,/turf/simulated/shuttle/floor/white,/area/submap/CrashedMedShuttle)
"bR" = (/obj/structure/table/standard,/obj/random/medical/lite,/obj/item/weapon/surgical/retractor,/turf/simulated/shuttle/floor/white,/area/submap/CrashedMedShuttle)
"bS" = (/obj/item/weapon/material/shard,/obj/structure/grille,/turf/simulated/shuttle/plating,/area/submap/CrashedMedShuttle)
"bT" = (/obj/machinery/light{dir = 8},/obj/structure/table/standard,/obj/structure/loot_pile/maint/technical,/turf/simulated/shuttle/floor/purple,/area/submap/CrashedMedShuttle)
"bU" = (/obj/effect/decal/cleanable/blood/gibs/robot,/obj/effect/spider/cocoon,/turf/simulated/shuttle/floor/white,/area/submap/CrashedMedShuttle)
"bV" = (/obj/machinery/light{icon_state = "tube1"; dir = 4},/obj/structure/closet/secure_closet/medical_wall/anesthetics{pixel_x = 32},/obj/item/weapon/material/shard{icon_state = "medium"},/turf/simulated/shuttle/floor/white,/area/submap/CrashedMedShuttle)
"bW" = (/obj/machinery/light{dir = 8; icon_state = "tube1"; pixel_y = 0},/turf/simulated/shuttle/floor/white,/area/submap/CrashedMedShuttle)
"bX" = (/obj/effect/spider/cocoon,/turf/simulated/shuttle/floor/white,/area/submap/CrashedMedShuttle)
"bY" = (/mob/living/simple_animal/hostile/giant_spider/nurse{returns_home = 1},/turf/simulated/shuttle/floor/white,/area/submap/CrashedMedShuttle)
"bZ" = (/obj/effect/decal/cleanable/blood/splatter,/obj/structure/loot_pile/surface/bones,/obj/effect/spider/stickyweb,/obj/effect/spider/stickyweb,/obj/item/weapon/surgical/surgicaldrill,/turf/simulated/shuttle/floor/white,/area/submap/CrashedMedShuttle)
"ca" = (/obj/structure/table/standard,/obj/item/weapon/storage/firstaid/combat,/obj/random/firstaid,/turf/simulated/shuttle/floor/white,/area/submap/CrashedMedShuttle)
"cb" = (/obj/item/weapon/material/shard{icon_state = "medium"},/obj/structure/grille,/turf/simulated/shuttle/plating,/area/submap/CrashedMedShuttle)
"cc" = (/obj/structure/table/standard,/obj/item/device/reagent_scanner/adv,/turf/simulated/shuttle/floor/purple,/area/submap/CrashedMedShuttle)
"cd" = (/obj/machinery/iv_drip,/obj/item/weapon/reagent_containers/blood/OMinus,/turf/simulated/shuttle/floor/white,/area/submap/CrashedMedShuttle)
"ce" = (/obj/structure/table/standard,/obj/item/weapon/storage/box/masks,/obj/item/weapon/storage/box/gloves,/obj/random/medical,/obj/random/medical,/obj/random/medical,/turf/simulated/shuttle/floor/white,/area/submap/CrashedMedShuttle)
"cf" = (/obj/effect/spider/stickyweb,/obj/structure/door_assembly/door_assembly_ext,/turf/simulated/shuttle/plating,/area/submap/CrashedMedShuttle)
"cg" = (/obj/structure/table/standard,/obj/item/device/healthanalyzer/enhanced,/obj/random/firstaid,/turf/simulated/shuttle/floor/white,/area/submap/CrashedMedShuttle)
"ch" = (/obj/structure/table/standard,/obj/item/weapon/storage/backpack/medic,/obj/random/medical/lite,/turf/simulated/shuttle/floor/white,/area/submap/CrashedMedShuttle)
"ci" = (/obj/structure/table/standard,/obj/effect/spider/stickyweb,/obj/random/medical,/obj/random/medical,/turf/simulated/shuttle/floor/white,/area/submap/CrashedMedShuttle)
"cj" = (/obj/structure/table/standard,/obj/effect/spider/stickyweb,/obj/random/medical,/turf/simulated/shuttle/floor/white,/area/submap/CrashedMedShuttle)
"ck" = (/obj/structure/girder,/turf/simulated/shuttle/plating,/area/submap/CrashedMedShuttle)
"cl" = (/obj/machinery/vending/medical,/turf/simulated/shuttle/floor/white,/area/submap/CrashedMedShuttle)
"cm" = (/obj/structure/table/standard,/obj/structure/sign/periodic{pixel_y = -32},/obj/item/weapon/surgical/bonesetter,/obj/item/weapon/surgical/scalpel,/turf/simulated/shuttle/floor/white,/area/submap/CrashedMedShuttle)
"cn" = (/obj/machinery/optable,/obj/effect/decal/cleanable/blood/splatter,/obj/structure/loot_pile/surface/bones,/obj/random/medical/pillbottle,/turf/simulated/shuttle/floor/white,/area/submap/CrashedMedShuttle)
"co" = (/obj/structure/table/standard,/obj/item/weapon/surgical/bonegel,/obj/item/weapon/surgical/FixOVein,/turf/simulated/shuttle/floor/white,/area/submap/CrashedMedShuttle)
"cp" = (/obj/machinery/embedded_controller/radio/simple_docking_controller{frequency = 1380; id_tag = "admin_shuttle"; pixel_x = -25; pixel_y = 0; req_one_access = list(101); tag_door = "admin_shuttle_hatch"},/mob/living/simple_animal/hostile/giant_spider/nurse{returns_home = 1},/turf/simulated/shuttle/plating,/area/submap/CrashedMedShuttle)
"cq" = (/obj/structure/table/standard,/obj/item/weapon/storage/belt/medical/emt,/turf/simulated/shuttle/floor/white,/area/submap/CrashedMedShuttle)
"cr" = (/obj/structure/table/standard,/obj/item/weapon/storage/box/syringes,/obj/item/weapon/storage/box/autoinjectors,/obj/effect/spider/stickyweb,/obj/machinery/light,/turf/simulated/shuttle/floor/white,/area/submap/CrashedMedShuttle)
"cs" = (/obj/structure/table/standard,/obj/structure/closet/secure_closet/medical_wall/pills{pixel_x = 32},/turf/simulated/shuttle/floor/white,/area/submap/CrashedMedShuttle)
"ct" = (/obj/machinery/door/airlock/external{frequency = 1380; icon_state = "door_locked"; id_tag = "admin_shuttle_hatch"; locked = 1; name = "Shuttle Hatch"; req_access = null},/turf/simulated/shuttle/plating,/area/submap/CrashedMedShuttle)
"cu" = (/mob/living/bot/medbot,/turf/simulated/mineral/floor/ignore_mapgen,/area/submap/CrashedMedShuttle)

(1,1,1) = {"
aaaaaaaaaaaaaaaaaaaaaaaaaaaaaaaaaaaaaaaaaaaa
aaaaaaaaaaaaabaaaaabacadaeafagagagaaaaaaabaa
aaaaaaababaaaaahabaiadajagakalamagagagaaaaaa
aaaaaaaaaaaaaaabanagaoapagaqarasatauagagaaaa
aaaaaaaaahaaabavawagaxasayazaAaBaraCaDafabaa
aaababaaaEabaFaGaHafasaIagaJaKaLaMaNaOaPabaa
aaabaaaaaQaRacaSaTayasaraUagagagagagagagabaa
aaaaaaaaababaVaWaXafaraYaZbaafabbbaabcabaaaa
aaaaaabdbebfagagagagbgbhbibjbkblbmbnababaaaa
aaaaaabobpbqasbrbsafbtbubvbhbwbxbybzabaaaaaa
aaaaabbAbBbCasasaBbDarasagbEbEbFagagagagaaaa
aEabbGbHbIbJbKarasafarbLagbMbNbObPbQbRbSabaa
aaabagagbTbCbUasbVagbWbXbDasbYasaBbZcacbabaa
aaaaabagagcccdbYceagcfaoagcgaschcicjckckaaaa
aaaaaaabagclcmcncoagcpajagcqcrcsagckckabaaaa
aaaaaaabagagagagagaectctaeafagagckabababaaaa
aaaaaaaaababababcuababaaaaaaababaaaaaaaaaaaa
"}
