"aa" = (/turf/simulated/mineral/floor/ignore_mapgen,/area/submap/CrashedMedShuttle)
"ab" = (/turf/simulated/floor/outdoors/rocks{outdoors = 0},/area/submap/CrashedMedShuttle)
"ac" = (/obj/effect/decal/cleanable/liquid_fuel,/turf/simulated/mineral/floor/ignore_mapgen,/area/submap/CrashedMedShuttle)
"ad" = (/turf/simulated/mineral,/area/submap/CrashedMedShuttle)
"ae" = (/obj/structure/sign/greencross{desc = "White cross in a green field, you can get medical aid here."; name = "First-Aid"},/turf/simulated/shuttle/wall/no_join,/area/submap/CrashedMedShuttle)
"af" = (/obj/item/weapon/circuitboard/broken,/obj/effect/decal/cleanable/liquid_fuel,/turf/simulated/shuttle/plating,/area/submap/CrashedMedShuttle)
"ag" = (/turf/simulated/shuttle/wall,/area/submap/CrashedMedShuttle)
"ah" = (/obj/item/weapon/material/shard{icon_state = "medium"},/turf/simulated/shuttle/floor/white,/area/submap/CrashedMedShuttle)
"ai" = (/obj/structure/grille,/obj/structure/window/reinforced/full,/obj/structure/window/reinforced{dir = 1},/obj/structure/window/reinforced{dir = 8},/obj/structure/window/reinforced,/obj/structure/window/reinforced{dir = 4; health = 1e+006},/turf/simulated/shuttle/plating,/area/submap/CrashedMedShuttle)
"aj" = (/obj/machinery/light/small{dir = 4; pixel_y = 0},/obj/structure/sign/warning/airlock{pixel_x = 32},/obj/effect/spider/stickyweb,/turf/simulated/shuttle/plating,/area/submap/CrashedMedShuttle)
"ak" = (/turf/simulated/shuttle/floor/white,/area/submap/CrashedMedShuttle)
"al" = (/obj/structure/bed,/turf/simulated/shuttle/floor/white,/area/submap/CrashedMedShuttle)
"am" = (/obj/structure/table/standard,/turf/simulated/shuttle/floor/white,/area/submap/CrashedMedShuttle)
"an" = (/obj/item/weapon/material/shard{icon_state = "medium"},/obj/effect/decal/cleanable/blood/oil,/obj/structure/lattice,/turf/simulated/floor/outdoors/rocks{outdoors = 0},/area/submap/CrashedMedShuttle)
"ao" = (/obj/item/weapon/circuitboard/broken,/obj/structure/door_assembly/door_assembly_ext,/turf/simulated/shuttle/plating,/area/submap/CrashedMedShuttle)
"ap" = (/obj/structure/door_assembly/door_assembly_ext,/turf/simulated/shuttle/plating,/area/submap/CrashedMedShuttle)
"aq" = (/obj/effect/spider/stickyweb,/obj/effect/decal/cleanable/liquid_fuel,/turf/simulated/shuttle/plating,/area/submap/CrashedMedShuttle)
"ar" = (/obj/structure/closet/crate/medical,/obj/random/medical,/obj/random/medical,/turf/simulated/shuttle/floor/white,/area/submap/CrashedMedShuttle)
"as" = (/obj/structure/table/standard,/obj/machinery/cell_charger,/turf/simulated/shuttle/floor/white,/area/submap/CrashedMedShuttle)
"at" = (/obj/machinery/light{dir = 1},/obj/structure/table/standard,/turf/simulated/shuttle/floor/white,/area/submap/CrashedMedShuttle)
"au" = (/obj/structure/closet/secure_closet/personal/patient,/obj/effect/spider/stickyweb,/turf/simulated/shuttle/floor/white,/area/submap/CrashedMedShuttle)
"av" = (/obj/structure/window/reinforced,/obj/effect/decal/cleanable/blood/oil,/obj/structure/bed,/turf/simulated/shuttle/floor/white,/area/submap/CrashedMedShuttle)
"aw" = (/obj/machinery/door/airlock/glass,/turf/simulated/shuttle/floor/white,/area/submap/CrashedMedShuttle)
"ax" = (/obj/effect/decal/cleanable/blood/drip,/obj/effect/decal/cleanable/liquid_fuel,/turf/simulated/shuttle/floor/white,/area/submap/CrashedMedShuttle)
"ay" = (/obj/effect/decal/cleanable/blood,/obj/effect/decal/cleanable/liquid_fuel,/turf/simulated/shuttle/floor/white,/area/submap/CrashedMedShuttle)
"az" = (/turf/template_noop,/area/submap/CrashedMedShuttle)
"aA" = (/obj/effect/decal/cleanable/liquid_fuel,/turf/simulated/shuttle/floor/white,/area/submap/CrashedMedShuttle)
"aB" = (/obj/item/weapon/material/shard{icon_state = "medium"},/turf/simulated/shuttle/wall,/area/submap/CrashedMedShuttle)
"aC" = (/obj/item/weapon/material/shard,/turf/simulated/shuttle/floor/white,/area/submap/CrashedMedShuttle)
"aD" = (/obj/structure/closet/secure_closet/personal/patient,/turf/simulated/shuttle/floor/white,/area/submap/CrashedMedShuttle)
"aE" = (/obj/effect/decal/cleanable/blood/drip,/turf/simulated/shuttle/floor/white,/area/submap/CrashedMedShuttle)
"aF" = (/obj/machinery/door/airlock/glass,/obj/effect/decal/cleanable/liquid_fuel,/turf/simulated/shuttle/floor/white,/area/submap/CrashedMedShuttle)
"aG" = (/obj/structure/window/reinforced{dir = 4},/obj/structure/shuttle/engine/heater{icon_state = "heater"; dir = 8},/turf/simulated/shuttle/plating,/area/submap/CrashedMedShuttle)
"aH" = (/obj/item/stack/rods,/turf/simulated/shuttle/floor/white,/area/submap/CrashedMedShuttle)
"aI" = (/obj/structure/table/standard,/obj/effect/spider/stickyweb,/obj/machinery/light,/turf/simulated/shuttle/floor/white,/area/submap/CrashedMedShuttle)
"aJ" = (/obj/structure/table/standard,/obj/effect/spider/stickyweb,/turf/simulated/shuttle/floor/white,/area/submap/CrashedMedShuttle)
"aK" = (/obj/structure/table/standard,/obj/item/weapon/material/shard{icon_state = "medium"},/obj/effect/spider/stickyweb,/turf/simulated/shuttle/floor/white,/area/submap/CrashedMedShuttle)
"aL" = (/obj/structure/grille/broken,/obj/item/weapon/material/shard{icon_state = "medium"},/obj/item/stack/rods,/turf/simulated/shuttle/plating,/area/submap/CrashedMedShuttle)
"aM" = (/mob/living/bot/medbot/mysterious{desc = "Little beat up and dented, still ready to serve."; name = "\improper Kito"},/turf/simulated/shuttle/floor/white,/area/submap/CrashedMedShuttle)
"aN" = (/obj/structure/grille,/obj/structure/window/reinforced{dir = 1},/obj/structure/window/reinforced{dir = 8},/obj/structure/window/reinforced{dir = 4; health = 1e+006},/obj/item/weapon/material/shard{icon_state = "medium"},/turf/simulated/shuttle/plating,/area/submap/CrashedMedShuttle)
"aO" = (/obj/effect/decal/cleanable/blood/oil,/turf/simulated/shuttle/floor/white,/area/submap/CrashedMedShuttle)
"aP" = (/obj/effect/decal/cleanable/blood/gibs/robot,/turf/simulated/shuttle/floor/white,/area/submap/CrashedMedShuttle)
"aQ" = (/obj/effect/spider/stickyweb,/turf/simulated/shuttle/floor/white,/area/submap/CrashedMedShuttle)
"aR" = (/turf/simulated/shuttle/wall/no_join,/area/submap/CrashedMedShuttle)
"aS" = (/obj/item/weapon/material/shard{icon_state = "medium"},/obj/effect/spider/stickyweb,/turf/simulated/shuttle/floor/white,/area/submap/CrashedMedShuttle)
"aT" = (/obj/machinery/light,/obj/structure/table/standard,/obj/effect/spider/stickyweb,/turf/simulated/shuttle/floor/white,/area/submap/CrashedMedShuttle)
"aU" = (/obj/structure/table/standard,/obj/item/weapon/material/shard{icon_state = "medium"},/turf/simulated/shuttle/floor/white,/area/submap/CrashedMedShuttle)
"aV" = (/obj/effect/spider/stickyweb,/turf/simulated/floor/outdoors/rocks,/area/submap/CrashedMedShuttle)
"aW" = (/turf/simulated/shuttle/floor/yellow,/area/submap/CrashedMedShuttle)
"aX" = (/obj/machinery/computer,/turf/simulated/shuttle/floor/yellow,/area/submap/CrashedMedShuttle)
"aY" = (/obj/structure/frame/computer,/turf/simulated/shuttle/floor/yellow,/area/submap/CrashedMedShuttle)
"aZ" = (/obj/effect/spider/stickyweb,/turf/simulated/mineral/floor/ignore_mapgen,/area/submap/CrashedMedShuttle)
"ba" = (/obj/structure/grille,/obj/structure/window/reinforced{dir = 1},/obj/structure/window/reinforced{dir = 8},/obj/item/weapon/material/shard{icon_state = "medium"},/turf/simulated/shuttle/plating,/area/submap/CrashedMedShuttle)
"bb" = (/obj/item/stack/rods,/turf/simulated/shuttle/wall,/area/submap/CrashedMedShuttle)
"bc" = (/obj/effect/spider/stickyweb,/turf/simulated/shuttle/wall,/area/submap/CrashedMedShuttle)
"bd" = (/obj/machinery/light{dir = 8; icon_state = "tube1"; pixel_y = 0},/obj/structure/extinguisher_cabinet{pixel_x = -32},/obj/structure/lattice,/turf/template_noop,/area/submap/CrashedMedShuttle)
"be" = (/obj/structure/bed/chair/shuttle{dir = 4},/turf/simulated/shuttle/floor/yellow,/area/submap/CrashedMedShuttle)
"bf" = (/obj/effect/decal/cleanable/blood/gibs/robot,/obj/item/weapon/firstaid_arm_assembly,/turf/simulated/shuttle/floor/white,/area/submap/CrashedMedShuttle)
"bg" = (/obj/effect/decal/cleanable/blood/splatter,/obj/effect/decal/cleanable/blood/drip,/obj/structure/lattice,/turf/simulated/shuttle/floor/yellow,/area/submap/CrashedMedShuttle)
"bh" = (/obj/structure/grille/broken,/obj/item/weapon/material/shard{icon_state = "medium"},/turf/simulated/shuttle/plating,/area/submap/CrashedMedShuttle)
"bi" = (/obj/item/weapon/material/shard,/obj/effect/spider/stickyweb,/obj/item/weapon/beartrap{anchored = 1; deployed = 1; icon_state = "beartrap1"},/obj/random/trash,/turf/simulated/shuttle/floor/purple,/area/submap/CrashedMedShuttle)
"bj" = (/obj/effect/decal/cleanable/blood/oil,/turf/simulated/shuttle/floor/purple,/area/submap/CrashedMedShuttle)
"bk" = (/obj/item/stack/rods,/turf/simulated/floor/outdoors/rocks{outdoors = 0},/area/submap/CrashedMedShuttle)
"bl" = (/obj/effect/spider/stickyweb,/obj/item/weapon/material/shard,/turf/simulated/shuttle/floor/white,/area/submap/CrashedMedShuttle)
"bm" = (/obj/structure/lattice,/turf/simulated/mineral/floor/ignore_mapgen,/area/submap/CrashedMedShuttle)
"bn" = (/obj/structure/grille/broken,/obj/item/weapon/material/shard,/turf/simulated/shuttle/plating,/area/submap/CrashedMedShuttle)
"bo" = (/obj/effect/decal/cleanable/blood/drip,/obj/effect/spider/stickyweb,/turf/simulated/mineral/floor/ignore_mapgen,/area/submap/CrashedMedShuttle)
"bp" = (/obj/structure{anchored = 1; density = 1; desc = "Once an artificial intelligence; now merely a brick of inert metal and circuits."; icon = 'icons/mob/AI.dmi'; icon_state = "ai-empty"; name = "V.I.T.A"},/turf/simulated/shuttle/floor/yellow,/area/submap/CrashedMedShuttle)
"bq" = (/obj/effect/decal/cleanable/blood/oil,/obj/structure/loot_pile/mecha/odysseus,/turf/simulated/mineral/floor/ignore_mapgen,/area/submap/CrashedMedShuttle)
"br" = (/obj/effect/decal/cleanable/blood/oil,/obj/effect/spider/stickyweb,/turf/simulated/shuttle/plating,/area/submap/CrashedMedShuttle)
"bs" = (/obj/item/weapon/material/shard,/obj/structure/loot_pile/maint/technical,/obj/structure/lattice,/turf/simulated/shuttle/floor/purple,/area/submap/CrashedMedShuttle)
"bt" = (/obj/effect/decal/cleanable/blood/drip,/turf/simulated/mineral/floor/ignore_mapgen,/area/submap/CrashedMedShuttle)
"bu" = (/obj/structure/girder/displaced,/turf/simulated/shuttle/plating,/area/submap/CrashedMedShuttle)
"bv" = (/obj/structure/shuttle/engine/heater{icon_state = "heater"; dir = 8},/obj/structure/window/reinforced{dir = 4},/turf/simulated/shuttle/plating,/area/submap/CrashedMedShuttle)
"bw" = (/obj/random/medical/pillbottle,/turf/simulated/shuttle/floor/white,/area/submap/CrashedMedShuttle)
"bx" = (/obj/structure/bed/chair/office/light{dir = 8},/turf/simulated/shuttle/floor/purple,/area/submap/CrashedMedShuttle)
"by" = (/obj/item/weapon/circuitboard/broken,/turf/simulated/shuttle/floor/white,/area/submap/CrashedMedShuttle)
"bz" = (/obj/structure/girder,/turf/template_noop,/area/submap/CrashedMedShuttle)
"bA" = (/obj/machinery/light{icon_state = "tube1"; dir = 4},/obj/item/weapon/material/shard{icon_state = "medium"},/turf/simulated/shuttle/floor/white,/area/submap/CrashedMedShuttle)
"bB" = (/obj/structure/shuttle/engine/propulsion{tag = "icon-propulsion_r (WEST)"; icon_state = "propulsion_r"; dir = 8},/turf/simulated/floor/outdoors/rocks,/area/submap/CrashedMedShuttle)
"bC" = (/obj/effect/decal/cleanable/blood/splatter,/obj/item/weapon/storage/backpack/medic,/obj/random/medical/lite,/turf/simulated/shuttle/floor/white,/area/submap/CrashedMedShuttle)
"bD" = (/obj/structure/loot_pile/mecha/odysseus,/turf/simulated/shuttle/floor/white,/area/submap/CrashedMedShuttle)
"bE" = (/obj/structure/table/standard,/turf/simulated/shuttle/floor/purple,/area/submap/CrashedMedShuttle)
"bF" = (/obj/structure/table,/turf/simulated/shuttle/floor/white,/area/submap/CrashedMedShuttle)
"bG" = (/obj/structure/table/standard,/obj/structure/sign/periodic{pixel_y = -32},/turf/simulated/shuttle/floor/white,/area/submap/CrashedMedShuttle)
"bH" = (/obj/machinery/optable,/obj/effect/decal/cleanable/blood/splatter,/turf/simulated/shuttle/floor/white,/area/submap/CrashedMedShuttle)
"bI" = (/turf/simulated/shuttle/plating,/area/submap/CrashedMedShuttle)
"bJ" = (/obj/machinery/light{dir = 1},/turf/simulated/shuttle/floor/white,/area/submap/CrashedMedShuttle)
"bK" = (/obj/structure/table/standard,/obj/item/weapon/surgical/retractor,/turf/simulated/shuttle/floor/white,/area/submap/CrashedMedShuttle)
"bL" = (/obj/item/weapon/material/shard,/obj/structure/grille,/turf/simulated/shuttle/plating,/area/submap/CrashedMedShuttle)
"bM" = (/obj/machinery/light{dir = 8},/obj/structure/table/standard,/obj/structure/loot_pile/maint/technical,/turf/simulated/shuttle/floor/purple,/area/submap/CrashedMedShuttle)
"bN" = (/mob/living/simple_animal/yithian,/turf/simulated/shuttle/floor/white,/area/submap/CrashedMedShuttle)
"bO" = (/obj/structure/table/standard,/obj/random/toolbox,/turf/simulated/shuttle/floor/white,/area/submap/CrashedMedShuttle)
"bP" = (/obj/machinery/light{dir = 8; icon_state = "tube1"; pixel_y = 0},/turf/simulated/shuttle/floor/white,/area/submap/CrashedMedShuttle)
"bQ" = (/obj/structure/boulder,/turf/simulated/mineral/floor/ignore_mapgen,/area/submap/CrashedMedShuttle)
"bS" = (/obj/item/weapon/material/shard{icon_state = "medium"},/obj/structure/grille,/turf/simulated/shuttle/plating,/area/submap/CrashedMedShuttle)
"bU" = (/obj/machinery/iv_drip,/obj/item/weapon/reagent_containers/blood/empty,/turf/simulated/shuttle/floor/white,/area/submap/CrashedMedShuttle)
"bZ" = (/obj/structure/table/standard,/obj/effect/spider/stickyweb,/obj/random/medical,/turf/simulated/shuttle/floor/white,/area/submap/CrashedMedShuttle)
"ca" = (/obj/structure/girder,/turf/simulated/shuttle/plating,/area/submap/CrashedMedShuttle)
"ck" = (/obj/effect/decal/remains/tajaran,/obj/item/weapon/surgical/circular_saw,/turf/simulated/floor/outdoors/rocks{outdoors = 0},/area/submap/CrashedMedShuttle)
"cm" = (/obj/machinery/door/airlock/external{icon_state = "door_locked"; locked = 1; name = "Shuttle Hatch"},/turf/simulated/shuttle/plating,/area/submap/CrashedMedShuttle)

(1,1,1) = {"
azazazaaaaaaaaaaaaaaaaacaaaaaaaaabadadadazaz
ababababababagagagagaeafapaeaiagagagadadadaz
azababababagagakahalanaqajagakatbOagagbzadad
azaaababagagakakakavagafapagaAakakarasbzbzad
abababagagaBakakaCauagaAaAaFaxayakakbfakaNab
aaabababaGaHaMaHaOaDaiakaEagaAaAaAaIaJaKaLab
aaabababaGaCaOakaSaPawakaQaRagagagagagagcaad
aaaaaaagagakakaOaTaUaiaQaEaWaXbaabaZaabQadad
ababababaBbbbcagagagagbdakbebgbhaZaVbqadadaz
aaaaabagagbibjakblakbLakbmbpaYbnbobtckadadaz
ababababbrbsbxakakakbyakakagcacabuagagcaadad
bkababbBbvbEbEbwakakaiaQakagamamambJakbKbLad
aaababagagbMbxaPakbAagbPakbyakbNakakbCbDbSad
aaabababagagbEbUakbFagcmaoagamakamambZcacaad
azaaaaaaabagagbGbHamagbIajagamaIamagcacaadad
ababababababagagagagaecmcmaeaiagagcaadadadaz
azaaaaaaababababaaababaaaaaaababbQadadadazaz
"}
