"aa" = (/turf/simulated/mineral/floor/ignore_mapgen,/area/submap/CrashedMedShuttle)
"ab" = (/turf/simulated/floor/outdoors/rocks{outdoors = 0},/area/submap/CrashedMedShuttle)
"ac" = (/obj/structure/lattice,/turf/simulated/floor/outdoors/rocks{outdoors = 0},/area/submap/CrashedMedShuttle)
"ad" = (/obj/effect/spider/stickyweb,/turf/simulated/shuttle/plating,/area/submap/CrashedMedShuttle)
"ae" = (/obj/structure/sign/greencross{desc = "White cross in a green field, you can get medical aid here."; name = "First-Aid"},/turf/simulated/shuttle/wall/no_join,/area/submap/CrashedMedShuttle)
"af" = (/obj/structure/lattice,/obj/item/weapon/ore,/turf/simulated/floor/outdoors/rocks{outdoors = 0},/area/submap/CrashedMedShuttle)
"ag" = (/turf/simulated/shuttle/wall,/area/submap/CrashedMedShuttle)
"ah" = (/obj/item/weapon/material/shard{icon_state = "medium"},/turf/simulated/mineral/floor/ignore_mapgen,/area/submap/CrashedMedShuttle)
"ai" = (/obj/structure/grille,/obj/structure/window/reinforced/full,/obj/structure/window/reinforced{dir = 1},/obj/structure/window/reinforced{dir = 8},/obj/structure/window/reinforced,/obj/structure/window/reinforced{dir = 4; health = 1e+006},/turf/simulated/shuttle/plating,/area/submap/CrashedMedShuttle)
"aj" = (/obj/machinery/light/small{dir = 4; pixel_y = 0},/obj/structure/sign/warning/airlock{pixel_x = 32},/obj/effect/spider/stickyweb,/turf/simulated/shuttle/plating,/area/submap/CrashedMedShuttle)
"ak" = (/turf/simulated/shuttle/floor/white,/area/submap/CrashedMedShuttle)
"al" = (/obj/machinery/light{dir = 1},/obj/structure/table/standard,/turf/simulated/shuttle/floor/white,/area/submap/CrashedMedShuttle)
"am" = (/obj/structure/table/standard,/turf/simulated/shuttle/floor/white,/area/submap/CrashedMedShuttle)
"an" = (/obj/item/weapon/material/shard{icon_state = "medium"},/obj/effect/decal/cleanable/blood/oil,/obj/structure/lattice,/turf/simulated/floor/outdoors/rocks{outdoors = 0},/area/submap/CrashedMedShuttle)
"ao" = (/obj/item/weapon/circuitboard/broken,/obj/structure/door_assembly/door_assembly_ext,/turf/simulated/shuttle/plating,/area/submap/CrashedMedShuttle)
"ap" = (/obj/structure/door_assembly/door_assembly_ext,/turf/simulated/shuttle/plating,/area/submap/CrashedMedShuttle)
"aq" = (/obj/effect/spider/stickyweb,/obj/structure/boulder,/turf/simulated/shuttle/plating,/area/submap/CrashedMedShuttle)
"ar" = (/obj/structure/closet/crate/medical,/obj/random/medical,/obj/random/medical,/turf/simulated/shuttle/floor/white,/area/submap/CrashedMedShuttle)
"as" = (/obj/structure/table/standard,/obj/machinery/cell_charger,/turf/simulated/shuttle/floor/white,/area/submap/CrashedMedShuttle)
"at" = (/obj/structure/window/reinforced,/obj/effect/decal/cleanable/blood/oil,/obj/structure/loot_pile/surface/bones,/obj/structure/lattice,/turf/simulated/floor/outdoors/rocks{outdoors = 0},/area/submap/CrashedMedShuttle)
"au" = (/obj/structure/closet/secure_closet/personal/patient,/obj/effect/spider/stickyweb,/turf/simulated/shuttle/floor/white,/area/submap/CrashedMedShuttle)
"av" = (/obj/machinery/light/small{dir = 4; pixel_y = 0},/obj/structure/sign/warning/airlock{pixel_x = 32},/obj/effect/spider/stickyweb,/obj/structure/boulder,/turf/simulated/shuttle/plating,/area/submap/CrashedMedShuttle)
"aw" = (/obj/machinery/door/airlock/glass,/turf/simulated/shuttle/floor/white,/area/submap/CrashedMedShuttle)
"ax" = (/obj/effect/decal/cleanable/blood/drip,/obj/effect/decal/cleanable/liquid_fuel,/turf/simulated/shuttle/floor/white,/area/submap/CrashedMedShuttle)
"ay" = (/obj/effect/decal/cleanable/blood,/obj/effect/decal/cleanable/liquid_fuel,/turf/simulated/shuttle/floor/white,/area/submap/CrashedMedShuttle)
"az" = (/turf/template_noop,/area/submap/CrashedMedShuttle)
"aA" = (/obj/item/stack/rods,/turf/simulated/mineral/floor/ignore_mapgen,/area/submap/CrashedMedShuttle)
"aB" = (/obj/item/weapon/material/shard,/obj/structure/lattice,/turf/simulated/floor/outdoors/rocks{outdoors = 0},/area/submap/CrashedMedShuttle)
"aC" = (/obj/item/weapon/ore,/turf/simulated/mineral/floor/ignore_mapgen,/area/submap/CrashedMedShuttle)
"aD" = (/obj/effect/decal/cleanable/liquid_fuel,/turf/simulated/shuttle/floor/white,/area/submap/CrashedMedShuttle)
"aE" = (/obj/structure/boulder,/turf/simulated/mineral/floor/ignore_mapgen,/area/submap/CrashedMedShuttle)
"aF" = (/obj/structure/reagent_dispensers/fueltank,/obj/effect/decal/cleanable/liquid_fuel,/turf/simulated/shuttle/floor/white,/area/submap/CrashedMedShuttle)
"aG" = (/obj/structure/reagent_dispensers/watertank,/obj/effect/decal/cleanable/liquid_fuel,/turf/simulated/shuttle/floor/white,/area/submap/CrashedMedShuttle)
"aH" = (/obj/machinery/recharge_station,/obj/effect/decal/cleanable/liquid_fuel,/turf/simulated/shuttle/floor/white,/area/submap/CrashedMedShuttle)
"aI" = (/obj/structure/table/standard,/obj/effect/spider/stickyweb,/obj/machinery/light,/turf/simulated/shuttle/floor/white,/area/submap/CrashedMedShuttle)
"aJ" = (/obj/structure/table/standard,/obj/effect/spider/stickyweb,/turf/simulated/shuttle/floor/white,/area/submap/CrashedMedShuttle)
"aK" = (/obj/structure/table/standard,/obj/item/weapon/material/shard{icon_state = "medium"},/obj/effect/spider/stickyweb,/turf/simulated/shuttle/floor/white,/area/submap/CrashedMedShuttle)
"aL" = (/obj/structure/grille/broken,/obj/item/weapon/material/shard{icon_state = "medium"},/obj/item/stack/rods,/turf/simulated/shuttle/plating,/area/submap/CrashedMedShuttle)
"aM" = (/obj/random/multiple/voidsuit/medical,/obj/effect/spider/stickyweb,/turf/simulated/floor/outdoors/rocks{outdoors = 0},/area/submap/CrashedMedShuttle)
"aN" = (/obj/structure/grille,/obj/structure/window/reinforced{dir = 1},/obj/structure/window/reinforced{dir = 8},/obj/structure/window/reinforced{dir = 4; health = 1e+006},/obj/item/weapon/material/shard{icon_state = "medium"},/turf/simulated/shuttle/plating,/area/submap/CrashedMedShuttle)
"aO" = (/obj/effect/decal/cleanable/blood/oil,/turf/simulated/shuttle/floor/white,/area/submap/CrashedMedShuttle)
"aP" = (/obj/effect/decal/cleanable/blood/gibs/robot,/turf/simulated/shuttle/floor/white,/area/submap/CrashedMedShuttle)
"aQ" = (/obj/effect/spider/stickyweb,/turf/simulated/shuttle/floor/white,/area/submap/CrashedMedShuttle)
"aR" = (/turf/simulated/shuttle/wall/no_join,/area/submap/CrashedMedShuttle)
"aS" = (/obj/structure/lattice,/obj/item/stack/rods,/turf/simulated/floor/outdoors/rocks{outdoors = 0},/area/submap/CrashedMedShuttle)
"aT" = (/obj/machinery/light,/obj/structure/table/standard,/obj/effect/spider/stickyweb,/turf/simulated/shuttle/floor/white,/area/submap/CrashedMedShuttle)
"aU" = (/obj/structure/table/standard,/obj/item/weapon/material/shard{icon_state = "medium"},/obj/random/medical,/turf/simulated/shuttle/floor/white,/area/submap/CrashedMedShuttle)
"aV" = (/obj/effect/spider/stickyweb,/turf/simulated/floor/outdoors/rocks,/area/submap/CrashedMedShuttle)
"aW" = (/obj/item/weapon/material/shard,/turf/simulated/floor/outdoors/rocks{outdoors = 0},/area/submap/CrashedMedShuttle)
"aX" = (/obj/machinery/computer,/turf/simulated/shuttle/floor/yellow,/area/submap/CrashedMedShuttle)
"aY" = (/obj/structure/frame/computer,/turf/simulated/shuttle/floor/yellow,/area/submap/CrashedMedShuttle)
"aZ" = (/obj/effect/spider/stickyweb,/turf/simulated/mineral/floor/ignore_mapgen,/area/submap/CrashedMedShuttle)
"ba" = (/obj/structure/closet/secure_closet/personal/patient,/obj/random/multiple/voidsuit/medical,/turf/simulated/shuttle/floor/white,/area/submap/CrashedMedShuttle)
"bb" = (/obj/effect/decal/cleanable/blood/drip,/mob/living/simple_animal/hostile/shantak{cooperative = 1; returns_home = 1; wander_distance = 6},/turf/simulated/shuttle/floor/white,/area/submap/CrashedMedShuttle)
"bc" = (/obj/effect/decal/cleanable/blood/oil,/turf/simulated/floor/outdoors/rocks{outdoors = 0},/area/submap/CrashedMedShuttle)
"bd" = (/obj/effect/decal/cleanable/blood/oil,/obj/structure/loot_pile/surface/bones,/obj/structure/lattice,/turf/simulated/floor/outdoors/rocks{outdoors = 0},/area/submap/CrashedMedShuttle)
"be" = (/obj/effect/spider/stickyweb,/obj/structure/girder/displaced,/obj/structure/lattice,/turf/simulated/floor/outdoors/rocks,/area/submap/CrashedMedShuttle)
"bf" = (/obj/structure/table/standard,/obj/item/weapon/storage/toolbox/mechanical,/turf/simulated/shuttle/floor/white,/area/submap/CrashedMedShuttle)
"bg" = (/obj/effect/spider/stickyweb,/turf/simulated/floor/outdoors/rocks{outdoors = 0},/area/submap/CrashedMedShuttle)
"bh" = (/obj/effect/decal/cleanable/blood/drip,/turf/simulated/floor/outdoors/rocks{outdoors = 0},/area/submap/CrashedMedShuttle)
"bi" = (/obj/structure/grille/broken,/obj/item/weapon/material/shard{icon_state = "medium"},/obj/item/stack/rods,/obj/structure/boulder,/turf/simulated/shuttle/plating,/area/submap/CrashedMedShuttle)
"bj" = (/obj/item/weapon/material/shard,/obj/effect/spider/stickyweb,/obj/item/weapon/beartrap{anchored = 1; deployed = 1; icon_state = "beartrap1"},/obj/random/trash,/turf/simulated/floor/outdoors/rocks,/area/submap/CrashedMedShuttle)
"bk" = (/obj/structure/lattice,/obj/structure/loot_pile/maint/trash,/turf/simulated/floor/outdoors/rocks{outdoors = 0},/area/submap/CrashedMedShuttle)
"bl" = (/obj/effect/spider/stickyweb,/obj/item/weapon/material/shard,/turf/simulated/shuttle/floor/white,/area/submap/CrashedMedShuttle)
"bm" = (/obj/random/medical,/turf/simulated/shuttle/floor/white,/area/submap/CrashedMedShuttle)
"bn" = (/obj/machinery/light{dir = 8; icon_state = "tube1"; pixel_y = 0},/obj/structure/extinguisher_cabinet{pixel_x = -32},/obj/structure/lattice,/obj/item/device/gps/internal/poi,/turf/simulated/floor/outdoors/rocks{outdoors = 0},/area/submap/CrashedMedShuttle)
"bo" = (/obj/effect/decal/cleanable/blood/splatter,/obj/structure/loot_pile/surface/bones,/obj/effect/decal/cleanable/blood/drip,/obj/structure/lattice,/turf/simulated/floor/outdoors/rocks{outdoors = 0},/area/submap/CrashedMedShuttle)
"bp" = (/obj/structure{anchored = 1; density = 1; desc = "Once an artificial intelligence; now merely a brick of inert metal and circuits."; icon = 'icons/mob/AI.dmi'; icon_state = "ai-empty"; name = "V.I.T.A"},/turf/simulated/shuttle/floor/yellow,/area/submap/CrashedMedShuttle)
"bq" = (/obj/effect/decal/cleanable/blood/oil,/obj/structure/loot_pile/mecha/odysseus,/turf/simulated/mineral/floor/ignore_mapgen,/area/submap/CrashedMedShuttle)
"br" = (/obj/item/weapon/firstaid_arm_assembly,/turf/simulated/shuttle/floor/white,/area/submap/CrashedMedShuttle)
"bs" = (/obj/item/weapon/material/shard{icon_state = "medium"},/obj/effect/spider/stickyweb,/turf/simulated/shuttle/floor/white,/area/submap/CrashedMedShuttle)
"bt" = (/obj/effect/decal/cleanable/blood/drip,/turf/simulated/mineral/floor/ignore_mapgen,/area/submap/CrashedMedShuttle)
"bu" = (/obj/effect/decal/cleanable/blood/oil,/obj/structure/lattice,/turf/simulated/floor/outdoors/rocks{outdoors = 0},/area/submap/CrashedMedShuttle)
"bv" = (/obj/effect/decal/cleanable/blood/oil,/obj/effect/spider/stickyweb,/turf/simulated/floor/outdoors/rocks,/area/submap/CrashedMedShuttle)
"bw" = (/obj/item/weapon/material/shard,/obj/structure/loot_pile/maint/technical,/obj/structure/lattice,/turf/simulated/mineral/floor/ignore_mapgen,/area/submap/CrashedMedShuttle)
"bx" = (/obj/structure/bed/chair/office/light{dir = 8},/turf/simulated/shuttle/floor/purple,/area/submap/CrashedMedShuttle)
"by" = (/obj/item/weapon/circuitboard/broken,/turf/simulated/shuttle/floor/white,/area/submap/CrashedMedShuttle)
"bz" = (/obj/structure/grille,/obj/structure/window/reinforced{dir = 1},/obj/structure/window/reinforced{dir = 8},/obj/item/weapon/material/shard{icon_state = "medium"},/turf/simulated/shuttle/plating,/area/space)
"bA" = (/obj/item/stack/rods,/obj/structure/boulder,/turf/simulated/floor/outdoors/rocks{outdoors = 0},/area/submap/CrashedMedShuttle)
"bB" = (/obj/structure/shuttle/engine/propulsion{tag = "icon-propulsion_r (WEST)"; icon_state = "propulsion_r"; dir = 8},/turf/simulated/floor/outdoors/rocks,/area/submap/CrashedMedShuttle)
"bC" = (/obj/structure/shuttle/engine/heater{icon_state = "heater"; dir = 8},/obj/structure/window/reinforced{dir = 4},/turf/simulated/mineral/floor/ignore_mapgen,/area/submap/CrashedMedShuttle)
"bD" = (/obj/structure/boulder,/turf/simulated/floor/outdoors/rocks{outdoors = 0},/area/submap/CrashedMedShuttle)
"bE" = (/obj/structure/table/standard,/turf/simulated/shuttle/floor/purple,/area/submap/CrashedMedShuttle)
"bF" = (/obj/structure/shuttle/engine/propulsion{tag = "icon-propulsion_r (WEST)"; icon_state = "propulsion_r"; dir = 8},/turf/simulated/floor/outdoors/rocks{outdoors = 0},/area/submap/CrashedMedShuttle)
"bG" = (/obj/structure/table/standard,/obj/item/device/defib_kit/loaded,/turf/simulated/shuttle/floor/white,/area/submap/CrashedMedShuttle)
"bH" = (/obj/structure/table/standard,/obj/item/bodybag/cryobag,/turf/simulated/shuttle/floor/white,/area/submap/CrashedMedShuttle)
"bI" = (/obj/structure/table/standard,/obj/item/weapon/storage/box/bodybags,/turf/simulated/shuttle/floor/white,/area/submap/CrashedMedShuttle)
"bJ" = (/obj/machinery/light{dir = 1},/turf/simulated/shuttle/floor/white,/area/submap/CrashedMedShuttle)
"bK" = (/obj/structure/table/standard,/obj/item/weapon/surgical/retractor,/turf/simulated/shuttle/floor/white,/area/submap/CrashedMedShuttle)
"bL" = (/obj/item/weapon/material/shard,/obj/structure/grille,/turf/simulated/shuttle/plating,/area/submap/CrashedMedShuttle)
"bM" = (/obj/machinery/light{dir = 8},/obj/structure/table/standard,/obj/structure/loot_pile/maint/technical,/turf/simulated/shuttle/floor/purple,/area/submap/CrashedMedShuttle)
"bN" = (/obj/effect/decal/cleanable/blood/drip,/obj/effect/spider/stickyweb,/turf/simulated/mineral/floor/ignore_mapgen,/area/submap/CrashedMedShuttle)
"bO" = (/obj/machinery/light{icon_state = "tube1"; dir = 4},/obj/structure/closet/secure_closet/medical_wall/anesthetics{pixel_x = 32},/obj/item/weapon/material/shard{icon_state = "medium"},/turf/simulated/shuttle/floor/white,/area/submap/CrashedMedShuttle)
"bP" = (/obj/machinery/light{dir = 8; icon_state = "tube1"; pixel_y = 0},/turf/simulated/shuttle/floor/white,/area/submap/CrashedMedShuttle)
"bQ" = (/obj/structure/loot_pile/maint/trash,/turf/simulated/floor/outdoors/rocks{outdoors = 0},/area/submap/CrashedMedShuttle)
"bR" = (/obj/effect/decal/cleanable/blood/splatter,/obj/structure/loot_pile/surface/bones,/obj/item/weapon/surgical/surgicaldrill,/turf/simulated/shuttle/floor/white,/area/submap/CrashedMedShuttle)
"bS" = (/obj/item/weapon/material/shard{icon_state = "medium"},/obj/structure/grille,/turf/simulated/shuttle/plating,/area/submap/CrashedMedShuttle)
"bT" = (/obj/structure/table/standard,/obj/item/device/reagent_scanner/adv,/turf/simulated/shuttle/floor/purple,/area/submap/CrashedMedShuttle)
"bU" = (/obj/machinery/iv_drip,/obj/item/weapon/reagent_containers/blood/empty,/turf/simulated/shuttle/floor/white,/area/submap/CrashedMedShuttle)
"bV" = (/mob/living/simple_animal/hostile/shantak{cooperative = 1; returns_home = 1; wander_distance = 6},/turf/simulated/shuttle/floor/white,/area/submap/CrashedMedShuttle)
"bW" = (/obj/structure/table/standard,/obj/item/weapon/storage/box/masks,/turf/simulated/shuttle/floor/white,/area/submap/CrashedMedShuttle)
"bX" = (/obj/structure/table/standard,/obj/random/firstaid,/turf/simulated/shuttle/floor/white,/area/submap/CrashedMedShuttle)
"bY" = (/obj/structure/table/standard,/obj/item/weapon/storage/backpack/medic,/obj/random/medical/lite,/turf/simulated/shuttle/floor/white,/area/submap/CrashedMedShuttle)
"bZ" = (/obj/structure/table/standard,/obj/effect/spider/stickyweb,/obj/random/medical,/turf/simulated/shuttle/floor/white,/area/submap/CrashedMedShuttle)
"ca" = (/obj/structure/girder,/turf/simulated/shuttle/plating,/area/submap/CrashedMedShuttle)
"cb" = (/obj/structure/frame,/turf/simulated/shuttle/floor/white,/area/submap/CrashedMedShuttle)
"cc" = (/obj/structure/table/standard,/obj/random/firstaid,/turf/simulated/shuttle/floor/purple,/area/submap/CrashedMedShuttle)
"cd" = (/obj/machinery/optable,/obj/effect/decal/cleanable/blood/splatter,/obj/structure/loot_pile/surface/bones,/turf/simulated/shuttle/floor/white,/area/submap/CrashedMedShuttle)
"ce" = (/obj/random/medical/pillbottle,/turf/simulated/shuttle/floor/white,/area/submap/CrashedMedShuttle)
"cf" = (/obj/structure/loot_pile/maint/trash,/turf/simulated/shuttle/floor/white,/area/submap/CrashedMedShuttle)
"cg" = (/obj/structure/table/standard,/obj/item/weapon/storage/belt/medical/emt,/turf/simulated/shuttle/floor/white,/area/submap/CrashedMedShuttle)
"ch" = (/obj/structure/table/standard,/obj/item/weapon/storage/box/syringes,/obj/effect/spider/stickyweb,/obj/machinery/light,/turf/simulated/shuttle/floor/white,/area/submap/CrashedMedShuttle)
"ci" = (/obj/structure/table/standard,/obj/structure/sign/periodic{pixel_y = -32},/obj/item/weapon/surgical/scalpel,/turf/simulated/shuttle/floor/white,/area/submap/CrashedMedShuttle)
"cj" = (/obj/structure/shuttle/engine/heater{icon_state = "heater"; dir = 8},/obj/structure/window/reinforced{dir = 4},/turf/simulated/floor/outdoors/rocks{outdoors = 0},/area/submap/CrashedMedShuttle)
"ck" = (/obj/effect/decal/remains/tajaran,/obj/item/weapon/surgical/circular_saw,/turf/simulated/floor/outdoors/rocks{outdoors = 0},/area/submap/CrashedMedShuttle)
"cl" = (/obj/structure/table/standard,/obj/item/weapon/surgical/bonegel,/turf/simulated/shuttle/floor/white,/area/submap/CrashedMedShuttle)
"cm" = (/obj/machinery/door/airlock/external{icon_state = "door_locked"; locked = 1; name = "Shuttle Hatch"},/turf/simulated/shuttle/plating,/area/submap/CrashedMedShuttle)
"cn" = (/turf/simulated/shuttle/plating,/area/submap/CrashedMedShuttle)
"co" = (/obj/effect/decal/remains/ribcage,/turf/simulated/mineral/floor/ignore_mapgen,/area/submap/CrashedMedShuttle)
"cp" = (/turf/simulated/shuttle/floor/yellow,/area/submap/CrashedMedShuttle)
"cq" = (/obj/effect/decal/remains/deer,/turf/simulated/mineral/floor/ignore_mapgen,/area/submap/CrashedMedShuttle)
"cr" = (/obj/structure/grille/broken,/obj/item/weapon/material/shard{icon_state = "medium"},/turf/simulated/shuttle/plating,/area/submap/CrashedMedShuttle)
"cs" = (/obj/item/weapon/ore,/turf/simulated/shuttle/floor/yellow,/area/submap/CrashedMedShuttle)
"ct" = (/obj/structure/grille/broken,/obj/item/weapon/material/shard,/turf/simulated/shuttle/plating,/area/submap/CrashedMedShuttle)

(1,1,1) = {"
azazazaaaaaaaaaaaaaaaaaaaaaaaaaaaaaaaaaaazaz
azazaaaaaaaaabaacoabafadaeaiagagagaaaaaaabaz
azazaaababaaaaahabanaqavagakalbfagagagaaaaaa
azaCaaaaaaaaaaabatagaoapagaDakakarasagagaaaa
aaaaaEaaahaaabaBauagakakawaxayakakaPbraNabaa
aaabaMaaaAabaSaObaaiakbbagaFaGaHaIaJaKbiabaa
aaabbFcjaWbcbkbsaPawakaQaRagagagagagagagabaa
aaaaagagababbdaTaUaibgbhaXaYbzabaZaCaEabcqaa
aaaaaCagbAbeagagagagbnabcpbocraZaVbqbDbDaCaa
aaaaagagbjbuakblbmaLabacbpcsctbNbtckbQaEaEaa
aacqabbvbwbxakbVakbyakakaRagagagagagagagaEaa
aAabbBbCccbEceakbVaiaQakagbGbHbIbJcfbKbLabaa
aaabagagbMbxaPakbOagbPakbyakbVakakbRambSabaa
aaaaabagagbTbUakbWagadaoagbXakbYambZcacaaaaa
azaaaaabagcbcicdclagcnajagcgchamagcacaabaaaz
azazaaabagagagagagaecmcmaeaiagagcabDababazaz
azaaaaaaababababaaababaaaaaaababaaaCaaazazaz
"}
