"a" = (/turf/simulated/wall/solidrock{block_tele = 0},/area/submap/cave/IceCave1C)
"b" = (/turf/template_noop,/area/submap/cave/IceCave1C)
"c" = (/turf/simulated/floor/outdoors/ice{outdoors = 0},/area/submap/cave/IceCave1C)
"d" = (/obj/machinery/crystal/ice,/turf/simulated/floor/outdoors/ice{outdoors = 0},/area/submap/cave/IceCave1C)
"e" = (/obj/structure/loot_pile/surface/bones,/turf/simulated/mineral/floor/ignore_mapgen,/area/submap/cave/IceCave1C)
"f" = (/turf/simulated/mineral/floor/ignore_mapgen,/area/submap/cave/IceCave1C)
"g" = (/obj/machinery/crystal/ice,/turf/simulated/mineral/floor/ignore_mapgen,/area/submap/cave/IceCave1C)
"h" = (/obj/random/tool/power/anom,/turf/simulated/mineral/floor/ignore_mapgen,/area/submap/cave/IceCave1C)
"i" = (/obj/random/ammo,/turf/simulated/mineral/floor/ignore_mapgen,/area/submap/cave/IceCave1C)
"l" = (/obj/random/projectile/scrapped_ionrifle,/turf/simulated/floor/outdoors/ice{outdoors = 0},/area/submap/cave/IceCave1C)
"n" = (/obj/random/powercell/anom,/turf/simulated/mineral/floor/ignore_mapgen,/area/submap/cave/IceCave1C)
"u" = (/obj/random/trash,/turf/simulated/mineral/floor/ignore_mapgen,/area/submap/cave/IceCave1C)
"E" = (/obj/structure/loot_pile/surface/bones,/obj/random/multiple/voidsuit/vintage,/turf/simulated/mineral/floor/ignore_mapgen,/area/submap/cave/IceCave1C)
"G" = (/obj/random/outcrop,/turf/simulated/mineral/floor/ignore_mapgen,/area/submap/cave/IceCave1C)
"M" = (/obj/structure/loot_pile/maint/junk,/turf/simulated/mineral/floor/ignore_mapgen,/area/submap/cave/IceCave1C)
"O" = (/obj/structure/loot_pile/mecha/ripley/random_sprite,/turf/simulated/mineral/floor/ignore_mapgen,/area/submap/cave/IceCave1C)
"Y" = (/obj/random/unidentified_medicine/viral,/turf/simulated/mineral/floor/ignore_mapgen,/area/submap/cave/IceCave1C)

(1,1,1) = {"
bbbbbbbaaaaaaaaaaaabbbbbbbbbbbbbbbbbaaab
baaaaaaaaaaaaaaaaaaabbbbbbbbbbaaaaaaaaab
baccccccccccccccddaabbbbbbbbbbaaafYGGaab
bacdccccccccccccddaaabbbbbbbbaaaGfffghab
bacccccccccccccdaaaaaaaaaaaaaaaaOffffiab
baccccccccccccccaaaaaaaaaaaaaaanfffffEab
bacccccccccccdccaaaaaadccccldgfffffffaab
aaccccdcccccccccaaaaaacccccddggufGefgaab
aaccccccccccccccfffffGcdcccccfffaaaaaaab
aacccccdccccccccffggffccccdddgggaaaaaabb
aaccccccccdcccccaaaaaaddaaaaaaaaaaabbbbb
aaccdcccccccccccaaaaaaddagMffffaaaabbbbb
aadcccccccccccccaaggffgdagfffffaabbbbbbb
aaccccccccccccdcaafffffgaaafafgaabbbbbbb
aaaaaadddddddddfffffgfffffffaffaabbbbbbb
aaaaaaggGfffgddddggggggffgffaffabbbbbbbb
aaGGgfffffffffccaaaaaaaafffgagfabbbbbbbb
aaGfffffffffffccaaaaaaaaggggaffabbbbbbbb
aaaggfaaaaaaaaccaaaaaaaGfffffffabbbbbbbb
aaaaffaaaaaaaaccaaaaaaaffffffaaabbbbbbbb
aaaaffgaaaaaaaccccccddafffffgaabbbbbbbbb
aaaaaffgaaaaaaccccccddaagfaaaabbbbbbbbbb
aaaagfffaaabaaaaddccffgfffaaabbbbbbbbbbb
aaaggafffaabbaaaddccffffffaabbbbbbbbbbbb
faaaaafffgaabbaaaaaaaafffgaabbbbbbbbbbbb
ffaaaagffaabbbbbbbbbbaGGggaabbbbbbbbbbbb
fffffffffaabbbbbbbbbbaaaaaaabbbbbbbbbbbb
ffffffffaaabbbbbbbbbbbbbbbbabbbbbbbbbbbb
"}
